Grapheme	IPA
shāngǔ	ʂ a n ⁵⁵ + k u ²¹⁴
’àn	+ a n ⁵¹
jìnǚ	tɕ i ⁵¹ + n y ²¹⁴
zěnyàng	ts ə n ²¹⁴ j a ŋ ⁵¹
nǚrén	n y ²¹⁴ + ʐ ə n ³⁵
tánɡjiěmèi	t a ŋ ³⁵ + tɕ j ɛ ²¹⁴ + m əi ⁵¹
lǘ	l y ³⁵
nǚ_	n y ²¹⁴ +
’ér	ə˞ ³⁵
nǚ$	n y ²¹⁴
nǚ	n y ²¹⁴ +
lǜ$	l y ⁵¹
gūnong	k u ⁵⁵ + n ʊ ŋ ⁰
shénme	ʂ ə n ³⁵ + m ə ⁰
wànguānjié	w a n ⁵¹ + g w a n ⁵⁵ + tɕ j ɛ ³⁵
shǒuzhījia	ʂ ou ²¹⁴ + ʈʐ ʅ ⁵⁵ + tɕ j a ⁰
késou	kʰ ə ³⁵ + s ou ⁰
guòlǜ	k w ɔ ⁵¹ + l y ⁵¹
jiānguǒ	tɕ j ɛ n ⁵⁵ + k w ɔ ²¹⁴
dìfang	t i ⁵¹ + f a ŋ ⁰
zěnmeyàng	ts ə n ²¹⁴ + m ə ⁰ + j a ŋ ⁵¹
shénme_shíhou	ʂ ə n ³⁵ + m ə ⁰ + ʂ ʅ ³⁵ + x ou ⁰
nǎr	n a˞ ²¹⁴
_	+
āi_	ai ⁵⁵ +
ái_	ai ³⁵ +
ǎi_	ai ²¹⁴ +
ài_	ai ⁵¹ +
ān_	a n ⁵⁵ +
án_	a n ³⁵ +
ǎn_	a n ²¹⁴ +
àn_	a n ⁵¹ +
āng_	a ŋ ⁵⁵ +
áng_	a ŋ ³⁵ +
ǎng_	a ŋ ²¹⁴ +
àng_	a ŋ ⁵¹ +
āo_	au ⁵⁵ +
áo_	au ³⁵ +
ǎo_	au ²¹⁴ +
ào_	au ⁵¹ +
ba_	p a ⁰ +
bā_	p a ⁵⁵ +
bá_	p a ³⁵ +
bǎ_	p a ²¹⁴ +
bà_	p a ⁵¹ +
bāi_	p ai ⁵⁵ +
bái_	p ai ³⁵ +
bǎi_	p ai ²¹⁴ +
bài_	p ai ⁵¹ +
bān_	p a n ⁵⁵ +
bán_	p a n ³⁵ +
bǎn_	p a n ²¹⁴ +
bàn_	p a n ⁵¹ +
bāng_	p a ŋ ⁵⁵ +
báng_	p a ŋ ³⁵ +
bǎng_	p a ŋ ²¹⁴ +
bàng_	p a ŋ ⁵¹ +
bāo_	p au ⁵⁵ +
báo_	p au ³⁵ +
bǎo_	p au ²¹⁴ +
bào_	p au ⁵¹ +
bēi_	p ei ⁵⁵ +
béi_	p ei ³⁵ +
běi_	p ei ²¹⁴ +
bèi_	p ei ⁵¹ +
bēn_	p e n ⁵⁵ +
bén_	p e n ³⁵ +
běn_	p e n ²¹⁴ +
bèn_	p e n ⁵¹ +
biān_	p j ɛ n ⁵⁵ +
bián_	p j ɛ n ³⁵ +
biǎn_	p j ɛ n ²¹⁴ +
biàn_	p j ɛ n ⁵¹ +
biāo_	p j au ⁵⁵ +
biáo_	p j au ³⁵ +
biǎo_	p j au ²¹⁴ +
biào_	p j au ⁵¹ +
biē_	p j ɛ ⁵⁵ +
bié_	p j ɛ ³⁵ +
biě_	p j ɛ ²¹⁴ +
biè_	p j ɛ ⁵¹ +
bī_	p i ⁵⁵ +
bí_	p i ³⁵ +
bǐ_	p i ²¹⁴ +
bì_	p i ⁵¹ +
bīn_	p i n ⁵⁵ +
bín_	p i n ³⁵ +
bǐn_	p i n ²¹⁴ +
bìn_	p i n ⁵¹ +
bīng_	p i ŋ ⁵⁵ +
bíng_	p i ŋ ³⁵ +
bǐng_	p i ŋ ²¹⁴ +
bìng_	p i ŋ ⁵¹ +
bo_	p w o ⁰ +
bō_	p w o ⁵⁵ +
bó_	p w o ³⁵ +
bǒ_	p w o ²¹⁴ +
bò_	p w o ⁵¹ +
bū_	p u ⁵⁵ +
bú_	p u ³⁵ +
bǔ_	p u ²¹⁴ +
bù_	p u ⁵¹ +
cā_	tsʰ a ⁵⁵ +
cá_	tsʰ a ³⁵ +
cǎ_	tsʰ a ²¹⁴ +
cà_	tsʰ a ⁵¹ +
cāi_	tsʰ ai ⁵⁵ +
cái_	tsʰ ai ³⁵ +
cǎi_	tsʰ ai ²¹⁴ +
cài_	tsʰ ai ⁵¹ +
cān_	tsʰ a n ⁵⁵ +
cán_	tsʰ a n ³⁵ +
cǎn_	tsʰ a n ²¹⁴ +
càn_	tsʰ a n ⁵¹ +
cāng_	tsʰ a ŋ ⁵⁵ +
cáng_	tsʰ a ŋ ³⁵ +
cǎng_	tsʰ a ŋ ²¹⁴ +
càng_	tsʰ a ŋ ⁵¹ +
cāo_	tsʰ au ⁵⁵ +
cáo_	tsʰ au ³⁵ +
cǎo_	tsʰ au ²¹⁴ +
cào_	tsʰ au ⁵¹ +
cē_	tsʰ ə ⁵⁵ +
cé_	tsʰ ə ³⁵ +
cě_	tsʰ ə ²¹⁴ +
cè_	tsʰ ə ⁵¹ +
chā_	ʈʂʰ a ⁵⁵ +
chá_	ʈʂʰ a ³⁵ +
chǎ_	ʈʂʰ a ²¹⁴ +
chà_	ʈʂʰ a ⁵¹ +
chāi_	ʈʂʰ ai ⁵⁵ +
chái_	ʈʂʰ ai ³⁵ +
chǎi_	ʈʂʰ ai ²¹⁴ +
chài_	ʈʂʰ ai ⁵¹ +
chān_	ʈʂʰ a n ⁵⁵ +
chán_	ʈʂʰ a n ³⁵ +
chǎn_	ʈʂʰ a n ²¹⁴ +
chàn_	ʈʂʰ a n ⁵¹ +
chāng_	ʈʂ a ŋ ⁵⁵ +
cháng_	ʈʂ a ŋ ³⁵ +
chǎng_	ʈʂ a ŋ ²¹⁴ +
chàng_	ʈʂ a ŋ ⁵¹ +
chāo_	ʈʂ au ⁵⁵ +
cháo_	ʈʂ au ³⁵ +
chǎo_	ʈʂ au ²¹⁴ +
chào_	ʈʂ au ⁵¹ +
chen_	ʈʂ ə n ⁰ +
chē_	ʈʂ ə ⁵⁵ +
ché_	ʈʂ ə ³⁵ +
chě_	ʈʂ ə ²¹⁴ +
chè_	ʈʂ ə ⁵¹ +
chēn_	ʈʂ ə n ⁵⁵ +
chén_	ʈʂ ə n ³⁵ +
chěn_	ʈʂ ə n ²¹⁴ +
chèn_	ʈʂ ə n ⁵¹ +
chēng_	ʈʂ ə ŋ ⁵⁵ +
chéng_	ʈʂ ə ŋ ³⁵ +
chěng_	ʈʂ ə ŋ ²¹⁴ +
chèng_	ʈʂ ə ŋ ⁵¹ +
chī_	ʈʂ ʅ ⁵⁵ +
chí_	ʈʂ ʅ ³⁵ +
chǐ_	ʈʂ ʅ ²¹⁴ +
chì_	ʈʂ ʅ ⁵¹ +
chōng_	ʈʂ ʊ ŋ ⁵⁵ +
chóng_	ʈʂ ʊ ŋ ³⁵ +
chǒng_	ʈʂ ʊ ŋ ²¹⁴ +
chòng_	ʈʂ ʊ ŋ ⁵¹ +
chōu_	ʈʂ ɔu ⁵⁵ +
chóu_	ʈʂ ɔu ³⁵ +
chǒu_	ʈʂ ɔu ²¹⁴ +
chòu_	ʈʂ ɔu ⁵¹ +
chu_	ʈʂ u ⁰ +
chuān_	ʈʂ w a n ⁵⁵ +
chuán_	ʈʂ w a n ³⁵ +
chuǎn_	ʈʂ w a n ²¹⁴ +
chuàn_	ʈʂ w a n ⁵¹ +
chuāng_	ʈʂ w a ŋ ⁵⁵ +
chuáng_	ʈʂ w a ŋ ³⁵ +
chuǎng_	ʈʂ w a ŋ ²¹⁴ +
chuàng_	ʈʂ w a ŋ ⁵¹ +
chuī_	ʈʂ w əi ⁵⁵ +
chuí_	ʈʂ w əi ³⁵ +
chuǐ_	ʈʂ w əi ²¹⁴ +
chuì_	ʈʂ w əi ⁵¹ +
chū_	ʈʂ u ⁵⁵ +
chú_	ʈʂ u ³⁵ +
chǔ_	ʈʂ u ²¹⁴ +
chù_	ʈʂ u ⁵¹ +
chūn_	ʈʂ u n ⁵⁵ +
chún_	ʈʂ u n ³⁵ +
chǔn_	ʈʂ u n ²¹⁴ +
chùn_	ʈʂ u n ⁵¹ +
cī_	tsʰ ɿ ⁵⁵ +
cí_	tsʰ ɿ ³⁵ +
cǐ_	tsʰ ɿ ²¹⁴ +
cì_	tsʰ ɿ ⁵¹ +
cōng_	tsʰ ʊ ŋ ⁵⁵ +
cóng_	tsʰ ʊ ŋ ³⁵ +
cǒng_	tsʰ ʊ ŋ ²¹⁴ +
còng_	tsʰ ʊ ŋ ⁵¹ +
cuō_	tsʰ w ɔ ⁵⁵ +
cuó_	tsʰ w ɔ ³⁵ +
cuǒ_	tsʰ w ɔ ²¹⁴ +
cuò_	tsʰ w ɔ ⁵¹ +
cū_	tsʰ u ⁵⁵ +
cú_	tsʰ u ³⁵ +
cǔ_	tsʰ u ²¹⁴ +
cù_	tsʰ u ⁵¹ +
cūn_	tsʰ u n ⁵⁵ +
cún_	tsʰ u n ³⁵ +
cǔn_	tsʰ u n ²¹⁴ +
cùn_	tsʰ u n ⁵¹ +
dā_	t a ⁵⁵ +
dá_	t a ³⁵ +
dǎ_	t a ²¹⁴ +
dà_	t a ⁵¹ +
dāi_	t ai ⁵⁵ +
dái_	t ai ³⁵ +
dǎi_	t ai ²¹⁴ +
dài_	t ai ⁵¹ +
dān_	t a n ⁵⁵ +
dán_	t a n ³⁵ +
dǎn_	t a n ²¹⁴ +
dàn_	t a n ⁵¹ +
dāo_	t au ⁵⁵ +
dáo_	t au ³⁵ +
dǎo_	t au ²¹⁴ +
dào_	t au ⁵¹ +
de_	t ə ⁰ +
dē_	t ə ⁵⁵ +
dé_	t ə ³⁵ +
dě_	t ə ²¹⁴ +
dè_	t ə ⁵¹ +
dēng_	t ə ŋ ⁵⁵ +
déng_	t ə ŋ ³⁵ +
děng_	t ə ŋ ²¹⁴ +
dèng_	t ə ŋ ⁵¹ +
di_	t i ⁰ +
diān_	t j ɛ n ⁵⁵ +
dián_	t j ɛ n ³⁵ +
diǎn_	t j ɛ n ²¹⁴ +
diàn_	t j ɛ n ⁵¹ +
diāo_	t j au ⁵⁵ +
diáo_	t j au ³⁵ +
diǎo_	t j au ²¹⁴ +
diào_	t j au ⁵¹ +
diē_	t j ə ⁵⁵ +
dié_	t j ə ³⁵ +
diě_	t j ə ²¹⁴ +
diè_	t j ə ⁵¹ +
dī_	t i ⁵⁵ +
dí_	t i ³⁵ +
dǐ_	t i ²¹⁴ +
dì_	t i ⁵¹ +
dīng_	t i ŋ ⁵⁵ +
díng_	t i ŋ ³⁵ +
dǐng_	t i ŋ ²¹⁴ +
dìng_	t i ŋ ⁵¹ +
dōng_	t ʊ ŋ ⁵⁵ +
dóng_	t ʊ ŋ ³⁵ +
dǒng_	t ʊ ŋ ²¹⁴ +
dòng_	t ʊ ŋ ⁵¹ +
dōu_	t ɔu ⁵⁵ +
dóu_	t ɔu ³⁵ +
dǒu_	t ɔu ²¹⁴ +
dòu_	t ɔu ⁵¹ +
duān_	t w a n ⁵⁵ +
duán_	t w a n ³⁵ +
duǎn_	t w a n ²¹⁴ +
duàn_	t w a n ⁵¹ +
duī_	t w əi ⁵⁵ +
duí_	t w əi ³⁵ +
duǐ_	t w əi ²¹⁴ +
duì_	t w əi ⁵¹ +
duo_	t w ɔ ⁰ +
duō_	t w ɔ ⁵⁵ +
duó_	t w ɔ ³⁵ +
duǒ_	t w ɔ ²¹⁴ +
duò_	t w ɔ ⁵¹ +
dū_	t u ⁵⁵ +
dú_	t u ³⁵ +
dǔ_	t u ²¹⁴ +
dù_	t u ⁵¹ +
dūn_	t ʊ n ⁵⁵ +
dún_	t ʊ n ³⁵ +
dǔn_	t ʊ n ²¹⁴ +
dùn_	t ʊ n ⁵¹ +
e_	ə ⁰ +
ē_	ə ⁵⁵ +
é_	ə ³⁵ +
ě_	ə ²¹⁴ +
è_	ə ⁵¹ +
ēr_	ɚ ⁵⁵ +
ér_	ɚ ³⁵ +
ěr_	ɚ ²¹⁴ +
èr_	ɚ ⁵¹ +
fa_	f a ⁰ +
fā_	f a ⁵⁵ +
fá_	f a ³⁵ +
fǎ_	f a ²¹⁴ +
fà_	f a ⁵¹ +
fān_	f a n ⁵⁵ +
fán_	f a n ³⁵ +
fǎn_	f a n ²¹⁴ +
fàn_	f a n ⁵¹ +
fāng_	f a ŋ ⁵⁵ +
fáng_	f a ŋ ³⁵ +
fǎng_	f a ŋ ²¹⁴ +
fàng_	f a ŋ ⁵¹ +
fen_	f ə n ⁰ +
feng_	f ə ŋ ⁰ +
fēi_	f əi ⁵⁵ +
féi_	f əi ³⁵ +
fěi_	f əi ²¹⁴ +
fèi_	f əi ⁵¹ +
fēn_	f ə n ⁵⁵ +
fén_	f ə n ³⁵ +
fěn_	f ə n ²¹⁴ +
fèn_	f ə n ⁵¹ +
fēng_	f ə ŋ ⁵⁵ +
féng_	f ə ŋ ³⁵ +
fěng_	f ə ŋ ²¹⁴ +
fèng_	f ə ŋ ⁵¹ +
fōu_	f ɔu ⁵⁵ +
fóu_	f ɔu ³⁵ +
fǒu_	f ɔu ²¹⁴ +
fòu_	f ɔu ⁵¹ +
fu_	f u ⁰ +
fū_	f u ⁵⁵ +
fú_	f u ³⁵ +
fǔ_	f u ²¹⁴ +
fù_	f u ⁵¹ +
gāi_	k ai ⁵⁵ +
gái_	k ai ³⁵ +
gǎi_	k ai ²¹⁴ +
gài_	k ai ⁵¹ +
gān_	k a n ⁵⁵ +
gán_	k a n ³⁵ +
gǎn_	k a n ²¹⁴ +
gàn_	k a n ⁵¹ +
gāng_	k a ŋ ⁵⁵ +
gáng_	k a ŋ ³⁵ +
gǎng_	k a ŋ ²¹⁴ +
gàng_	k a ŋ ⁵¹ +
gāo_	k au ⁵⁵ +
gáo_	k au ³⁵ +
gǎo_	k au ²¹⁴ +
gào_	k au ⁵¹ +
ge_	k ə ⁰ +
gē_	k ə ⁵⁵ +
gé_	k ə ³⁵ +
gě_	k ə ²¹⁴ +
gè_	k ə ⁵¹ +
gēi_	k əi ⁵⁵ +
géi_	k əi ³⁵ +
gěi_	k əi ²¹⁴ +
gèi_	k əi ⁵¹ +
gēn_	k ə n ⁵⁵ +
gén_	k ə n ³⁵ +
gěn_	k ə n ²¹⁴ +
gèn_	k ə n ⁵¹ +
gēng_	k ə ŋ ⁵⁵ +
géng_	k ə ŋ ³⁵ +
gěng_	k ə ŋ ²¹⁴ +
gèng_	k ə ŋ ⁵¹ +
gong_	k ʊ ŋ ⁰ +
gōng_	k ʊ ŋ ⁵⁵ +
góng_	k ʊ ŋ ³⁵ +
gǒng_	k ʊ ŋ ²¹⁴ +
gòng_	k ʊ ŋ ⁵¹ +
gōu_	k ɔu ⁵⁵ +
góu_	k ɔu ³⁵ +
gǒu_	k ɔu ²¹⁴ +
gòu_	k ɔu ⁵¹ +
gu_	k u ⁰ +
guā_	k w a ⁵⁵ +
guá_	k w a ³⁵ +
guǎ_	k w a ²¹⁴ +
guà_	k w a ⁵¹ +
guāi_	k w ai ⁵⁵ +
guái_	k w ai ³⁵ +
guǎi_	k w ai ²¹⁴ +
guài_	k w ai ⁵¹ +
guān_	k w a n ⁵⁵ +
guán_	k w a n ³⁵ +
guǎn_	k w a n ²¹⁴ +
guàn_	k w a n ⁵¹ +
guāng_	k w a ŋ ⁵⁵ +
guáng_	k w a ŋ ³⁵ +
guǎng_	k w a ŋ ²¹⁴ +
guàng_	k w a ŋ ⁵¹ +
guī_	k w əi ⁵⁵ +
guí_	k w əi ³⁵ +
guǐ_	k w əi ²¹⁴ +
guì_	k w əi ⁵¹ +
guō_	k w ɔ ⁵⁵ +
guó_	k w ɔ ³⁵ +
guǒ_	k w ɔ ²¹⁴ +
guò_	k w ɔ ⁵¹ +
gū_	k u ⁵⁵ +
gú_	k u ³⁵ +
gǔ_	k u ²¹⁴ +
gù_	k u ⁵¹ +
gūn_	k ʊ n ⁵⁵ +
gún_	k ʊ n ³⁵ +
gǔn_	k ʊ n ²¹⁴ +
gùn_	k ʊ n ⁵¹ +
hā_	x a ⁵⁵ +
há_	x a ³⁵ +
hǎ_	x a ²¹⁴ +
hà_	x a ⁵¹ +
hāi_	x ai ⁵⁵ +
hái_	x ai ³⁵ +
hǎi_	x ai ²¹⁴ +
hài_	x ai ⁵¹ +
hān_	x a n ⁵⁵ +
hán_	x a n ³⁵ +
hǎn_	x a n ²¹⁴ +
hàn_	x a n ⁵¹ +
hāng_	x a ŋ ⁵⁵ +
háng_	x a ŋ ³⁵ +
hǎng_	x a ŋ ²¹⁴ +
hàng_	x a ŋ ⁵¹ +
hāo_	x au ⁵⁵ +
háo_	x au ³⁵ +
hǎo_	x au ²¹⁴ +
hào_	x au ⁵¹ +
hē_	x ə ⁵⁵ +
hé_	x ə ³⁵ +
hě_	x ə ²¹⁴ +
hè_	x ə ⁵¹ +
hēi_	x əi ⁵⁵ +
héi_	x əi ³⁵ +
hěi_	x əi ²¹⁴ +
hèi_	x əi ⁵¹ +
hēn_	x ə n ⁵⁵ +
hén_	x ə n ³⁵ +
hěn_	x ə n ²¹⁴ +
hèn_	x ə n ⁵¹ +
hēng_	x ə ŋ ⁵⁵ +
héng_	x ə ŋ ³⁵ +
hěng_	x ə ŋ ²¹⁴ +
hèng_	x ə ŋ ⁵¹ +
hōng_	x ʊ ŋ ⁵⁵ +
hóng_	x ʊ ŋ ³⁵ +
hǒng_	x ʊ ŋ ²¹⁴ +
hòng_	x ʊ ŋ ⁵¹ +
hōu_	x ɔu ⁵⁵ +
hóu_	x ɔu ³⁵ +
hǒu_	x ɔu ²¹⁴ +
hòu_	x ɔu ⁵¹ +
hu_	x u ⁰ +
huā_	x w a ⁵⁵ +
huá_	x w a ³⁵ +
huǎ_	x w a ²¹⁴ +
huà_	x w a ⁵¹ +
huāi_	x w ai ⁵⁵ +
huái_	x w ai ³⁵ +
huǎi_	x w ai ²¹⁴ +
huài_	x w ai ⁵¹ +
huān_	x w a n ⁵⁵ +
huán_	x w a n ³⁵ +
huǎn_	x w a n ²¹⁴ +
huàn_	x w a n ⁵¹ +
huāng_	x w a ŋ ⁵⁵ +
huáng_	x w a ŋ ³⁵ +
huǎng_	x w a ŋ ²¹⁴ +
huàng_	x w a ŋ ⁵¹ +
huī_	x w əi ⁵⁵ +
huí_	x w əi ³⁵ +
huǐ_	x w əi ²¹⁴ +
huì_	x w əi ⁵¹ +
huō_	x w ɔ ⁵⁵ +
huó_	x w ɔ ³⁵ +
huǒ_	x w ɔ ²¹⁴ +
huò_	x w ɔ ⁵¹ +
hū_	x u ⁵⁵ +
hú_	x u ³⁵ +
hǔ_	x u ²¹⁴ +
hù_	x u ⁵¹ +
hūn_	x ʊ n ⁵⁵ +
hún_	x ʊ n ³⁵ +
hǔn_	x ʊ n ²¹⁴ +
hùn_	x ʊ n ⁵¹ +
jiā_	tɕ j a ⁵⁵ +
jiá_	tɕ j a ³⁵ +
jiǎ_	tɕ j a ²¹⁴ +
jià_	tɕ j a ⁵¹ +
jiān_	tɕ j ɛ n ⁵⁵ +
jián_	tɕ j ɛ n ³⁵ +
jiǎn_	tɕ j ɛ n ²¹⁴ +
jiàn_	tɕ j ɛ n ⁵¹ +
jiāng_	tɕ j a ŋ ⁵⁵ +
jiáng_	tɕ j a ŋ ³⁵ +
jiǎng_	tɕ j a ŋ ²¹⁴ +
jiàng_	tɕ j a ŋ ⁵¹ +
jiāo_	tɕ j au ⁵⁵ +
jiáo_	tɕ j au ³⁵ +
jiǎo_	tɕ j au ²¹⁴ +
jiào_	tɕ j au ⁵¹ +
jie_	tɕ j ə ⁰ +
jiē_	tɕ j ə ⁵⁵ +
jié_	tɕ j ə ³⁵ +
jiě_	tɕ j ə ²¹⁴ +
jiè_	tɕ j ə ⁵¹ +
jing_	tɕ i ŋ ⁰ +
jiū_	tɕ j ɔu ⁵⁵ +
jiú_	tɕ j ɔu ³⁵ +
jiǔ_	tɕ j ɔu ²¹⁴ +
jiù_	tɕ j ɔu ⁵¹ +
jī_	tɕ i ⁵⁵ +
jí_	tɕ i ³⁵ +
jǐ_	tɕ i ²¹⁴ +
jì_	tɕ i ⁵¹ +
jīn_	tɕ i n ⁵⁵ +
jín_	tɕ i n ³⁵ +
jǐn_	tɕ i n ²¹⁴ +
jìn_	tɕ i n ⁵¹ +
jīng_	tɕ i ŋ ⁵⁵ +
jíng_	tɕ i ŋ ³⁵ +
jǐng_	tɕ i ŋ ²¹⁴ +
jìng_	tɕ i ŋ ⁵¹ +
jīnɡ_	tɕ i ŋ ⁵⁵ +
jínɡ_	tɕ i ŋ ³⁵ +
jǐnɡ_	tɕ i ŋ ²¹⁴ +
jìnɡ_	tɕ i ŋ ⁵¹ +
juē_	tɕ ɥ ə ⁵⁵ +
jué_	tɕ ɥ ə ³⁵ +
juě_	tɕ ɥ ə ²¹⁴ +
juè_	tɕ ɥ ə ⁵¹ +
jū_	tɕ y ⁵⁵ +
jú_	tɕ y ³⁵ +
jǔ_	tɕ y ²¹⁴ +
jù_	tɕ y ⁵¹ +
jūn_	tɕ y n ⁵⁵ +
jún_	tɕ y n ³⁵ +
jǔn_	tɕ y n ²¹⁴ +
jùn_	tɕ y n ⁵¹ +
kāi_	kʰ ai ⁵⁵ +
kái_	kʰ ai ³⁵ +
kǎi_	kʰ ai ²¹⁴ +
kài_	kʰ ai ⁵¹ +
kān_	kʰ a n ⁵⁵ +
kán_	kʰ a n ³⁵ +
kǎn_	kʰ a n ²¹⁴ +
kàn_	kʰ a n ⁵¹ +
kāng_	kʰ a ŋ ⁵⁵ +
káng_	kʰ a ŋ ³⁵ +
kǎng_	kʰ a ŋ ²¹⁴ +
kàng_	kʰ a ŋ ⁵¹ +
kāo_	kʰ au ⁵⁵ +
káo_	kʰ au ³⁵ +
kǎo_	kʰ au ²¹⁴ +
kào_	kʰ au ⁵¹ +
kē_	kʰ ə ⁵⁵ +
ké_	kʰ ə ³⁵ +
kě_	kʰ ə ²¹⁴ +
kè_	kʰ ə ⁵¹ +
kōng_	kʰ ʊ ŋ ⁵⁵ +
kóng_	kʰ ʊ ŋ ³⁵ +
kǒng_	kʰ ʊ ŋ ²¹⁴ +
kòng_	kʰ ʊ ŋ ⁵¹ +
kōu_	kʰ ɔu ⁵⁵ +
kóu_	kʰ ɔu ³⁵ +
kǒu_	kʰ ɔu ²¹⁴ +
kòu_	kʰ ɔu ⁵¹ +
kuā_	kʰ w a ⁵⁵ +
kuá_	kʰ w a ³⁵ +
kuǎ_	kʰ w a ²¹⁴ +
kuà_	kʰ w a ⁵¹ +
kuāi_	kʰ w ai ⁵⁵ +
kuái_	kʰ w ai ³⁵ +
kuǎi_	kʰ w ai ²¹⁴ +
kuài_	kʰ w ai ⁵¹ +
kuān_	kʰ w a n ⁵⁵ +
kuán_	kʰ w a n ³⁵ +
kuǎn_	kʰ w a n ²¹⁴ +
kuàn_	kʰ w a n ⁵¹ +
kuāng_	kʰ w a ŋ ⁵⁵ +
kuáng_	kʰ w a ŋ ³⁵ +
kuǎng_	kʰ w a ŋ ²¹⁴ +
kuàng_	kʰ w a ŋ ⁵¹ +
kuī_	kʰ w əi ⁵⁵ +
kuí_	kʰ w əi ³⁵ +
kuǐ_	kʰ w əi ²¹⁴ +
kuì_	kʰ w əi ⁵¹ +
kū_	kʰ u ⁵⁵ +
kú_	kʰ u ³⁵ +
kǔ_	kʰ u ²¹⁴ +
kù_	kʰ u ⁵¹ +
kūn_	kʰ ʊ n ⁵⁵ +
kún_	kʰ ʊ n ³⁵ +
kǔn_	kʰ ʊ n ²¹⁴ +
kùn_	kʰ ʊ n ⁵¹ +
lā_	l a ⁵⁵ +
lá_	l a ³⁵ +
lǎ_	l a ²¹⁴ +
là_	l a ⁵¹ +
lāi_	l ai ⁵⁵ +
lái_	l ai ³⁵ +
lǎi_	l ai ²¹⁴ +
lài_	l ai ⁵¹ +
lān_	l a n ⁵⁵ +
lán_	l a n ³⁵ +
lǎn_	l a n ²¹⁴ +
làn_	l a n ⁵¹ +
lāng_	l a ŋ ⁵⁵ +
láng_	l a ŋ ³⁵ +
lǎng_	l a ŋ ²¹⁴ +
làng_	l a ŋ ⁵¹ +
lāo_	l au ⁵⁵ +
láo_	l au ³⁵ +
lǎo_	l au ²¹⁴ +
lào_	l au ⁵¹ +
lē_	l ə ⁵⁵ +
lé_	l ə ³⁵ +
lě_	l ə ²¹⁴ +
lè_	l ə ⁵¹ +
lēi_	l əi ⁵⁵ +
léi_	l əi ³⁵ +
lěi_	l əi ²¹⁴ +
lèi_	l əi ⁵¹ +
lēng_	l ə ŋ ⁵⁵ +
léng_	l ə ŋ ³⁵ +
lěng_	l ə ŋ ²¹⁴ +
lèng_	l ə ŋ ⁵¹ +
li_	l i ⁰ +
liān_	l j ɛ n ⁵⁵ +
lián_	l j ɛ n ³⁵ +
liǎn_	l j ɛ n ²¹⁴ +
liàn_	l j ɛ n ⁵¹ +
liāng_	l j a ŋ ⁵⁵ +
liáng_	l j a ŋ ³⁵ +
liǎng_	l j a ŋ ²¹⁴ +
liàng_	l j a ŋ ⁵¹ +
liāo_	l j au ⁵⁵ +
liáo_	l j au ³⁵ +
liǎo_	l j au ²¹⁴ +
liào_	l j au ⁵¹ +
liē_	l j ə ⁵⁵ +
lié_	l j ə ³⁵ +
liě_	l j ə ²¹⁴ +
liè_	l j ə ⁵¹ +
liū_	l j ɔu ⁵⁵ +
liú_	l j ɔu ³⁵ +
liǔ_	l j ɔu ²¹⁴ +
liù_	l j ɔu ⁵¹ +
lī_	l i ⁵⁵ +
lí_	l i ³⁵ +
lǐ_	l i ²¹⁴ +
lì_	l i ⁵¹ +
līn_	l i n ⁵⁵ +
lín_	l i n ³⁵ +
lǐn_	l i n ²¹⁴ +
lìn_	l i n ⁵¹ +
līng_	l i ŋ ⁵⁵ +
líng_	l i ŋ ³⁵ +
lǐng_	l i ŋ ²¹⁴ +
lìng_	l i ŋ ⁵¹ +
lōng_	l ʊ ŋ ⁵⁵ +
lóng_	l ʊ ŋ ³⁵ +
lǒng_	l ʊ ŋ ²¹⁴ +
lòng_	l ʊ ŋ ⁵¹ +
lōu_	l ɔu ⁵⁵ +
lóu_	l ɔu ³⁵ +
lǒu_	l ɔu ²¹⁴ +
lòu_	l ɔu ⁵¹ +
lu_	l u ⁰ +
luān_	l w a n ⁵⁵ +
luán_	l w a n ³⁵ +
luǎn_	l w a n ²¹⁴ +
luàn_	l w a n ⁵¹ +
luō_	l w ɔ ⁵⁵ +
luó_	l w ɔ ³⁵ +
luǒ_	l w ɔ ²¹⁴ +
luò_	l w ɔ ⁵¹ +
lū_	l u ⁵⁵ +
lú_	l u ³⁵ +
lǔ_	l u ²¹⁴ +
lù_	l u ⁵¹ +
lūn_	l ʊ n ⁵⁵ +
lún_	l ʊ n ³⁵ +
lǔn_	l ʊ n ²¹⁴ +
lùn_	l ʊ n ⁵¹ +
mao_	m au ⁰ +
mā_	m a ⁵⁵ +
má_	m a ³⁵ +
mǎ_	m a ²¹⁴ +
mà_	m a ⁵¹ +
māi_	m ai ⁵⁵ +
mái_	m ai ³⁵ +
mǎi_	m ai ²¹⁴ +
mài_	m ai ⁵¹ +
mān_	m a n ⁵⁵ +
mán_	m a n ³⁵ +
mǎn_	m a n ²¹⁴ +
màn_	m a n ⁵¹ +
māng_	m a ŋ ⁵⁵ +
máng_	m a ŋ ³⁵ +
mǎng_	m a ŋ ²¹⁴ +
màng_	m a ŋ ⁵¹ +
māo_	m au ⁵⁵ +
máo_	m au ³⁵ +
mǎo_	m au ²¹⁴ +
mào_	m au ⁵¹ +
mei_	m əi ⁰ +
men_	m ə n ⁰ +
mēi_	m əi ⁵⁵ +
méi_	m əi ³⁵ +
měi_	m əi ²¹⁴ +
mèi_	m əi ⁵¹ +
mēn_	m ə n ⁵⁵ +
mén_	m ə n ³⁵ +
měn_	m ə n ²¹⁴ +
mèn_	m ə n ⁵¹ +
mēng_	m ə ŋ ⁵⁵ +
méng_	m ə ŋ ³⁵ +
měng_	m ə ŋ ²¹⁴ +
mèng_	m ə ŋ ⁵¹ +
miān_	m j ɛ n ⁵⁵ +
mián_	m j ɛ n ³⁵ +
miǎn_	m j ɛ n ²¹⁴ +
miàn_	m j ɛ n ⁵¹ +
miāo_	m j au ⁵⁵ +
miáo_	m j au ³⁵ +
miǎo_	m j au ²¹⁴ +
miào_	m j au ⁵¹ +
miē_	m j ə ⁵⁵ +
mié_	m j ə ³⁵ +
miě_	m j ə ²¹⁴ +
miè_	m j ə ⁵¹ +
ming_	m i ŋ ⁰ +
mī_	m i ⁵⁵ +
mí_	m i ³⁵ +
mǐ_	m i ²¹⁴ +
mì_	m i ⁵¹ +
mīn_	m i n ⁵⁵ +
mín_	m i n ³⁵ +
mǐn_	m i n ²¹⁴ +
mìn_	m i n ⁵¹ +
mīng_	m i ŋ ⁵⁵ +
míng_	m i ŋ ³⁵ +
mǐng_	m i ŋ ²¹⁴ +
mìng_	m i ŋ ⁵¹ +
mō_	m w ɔ ⁵⁵ +
mó_	m w ɔ ³⁵ +
mǒ_	m w ɔ ²¹⁴ +
mò_	m w ɔ ⁵¹ +
mōu_	m ɔu ⁵⁵ +
móu_	m ɔu ³⁵ +
mǒu_	m ɔu ²¹⁴ +
mòu_	m ɔu ⁵¹ +
mū_	m u ⁵⁵ +
mú_	m u ³⁵ +
mǔ_	m u ²¹⁴ +
mù_	m u ⁵¹ +
nā_	n a ⁵⁵ +
ná_	n a ³⁵ +
nǎ_	n a ²¹⁴ +
nà_	n a ⁵¹ +
nāi_	n ai ⁵⁵ +
nái_	n ai ³⁵ +
nǎi_	n ai ²¹⁴ +
nài_	n ai ⁵¹ +
nān_	n a n ⁵⁵ +
nán_	n a n ³⁵ +
nǎn_	n a n ²¹⁴ +
nàn_	n a n ⁵¹ +
nāo_	n au ⁵⁵ +
náo_	n au ³⁵ +
nǎo_	n au ²¹⁴ +
nào_	n au ⁵¹ +
niān_	n j ɛ n ⁵⁵ +
nián_	n j ɛ n ³⁵ +
niǎn_	n j ɛ n ²¹⁴ +
niàn_	n j ɛ n ⁵¹ +
niāo_	n j au ⁵⁵ +
niáo_	n j au ³⁵ +
niǎo_	n j au ²¹⁴ +
niào_	n j au ⁵¹ +
niē_	n j ə ⁵⁵ +
nié_	n j ə ³⁵ +
niě_	n j ə ²¹⁴ +
niè_	n j ə ⁵¹ +
niū_	n j ɔu ⁵⁵ +
niú_	n j ɔu ³⁵ +
niǔ_	n j ɔu ²¹⁴ +
niù_	n j ɔu ⁵¹ +
nī_	n i ⁵⁵ +
ní_	n i ³⁵ +
nǐ_	n i ²¹⁴ +
nì_	n i ⁵¹ +
nīng_	n i ŋ ⁵⁵ +
níng_	n i ŋ ³⁵ +
nǐng_	n i ŋ ²¹⁴ +
nìng_	n i ŋ ⁵¹ +
nong_	n ʊ ŋ ⁰ +
nōng_	n ʊ ŋ ⁵⁵ +
nóng_	n ʊ ŋ ³⁵ +
nǒng_	n ʊ ŋ ²¹⁴ +
nòng_	n ʊ ŋ ⁵¹ +
nuān_	n w a n ⁵⁵ +
nuán_	n w a n ³⁵ +
nuǎn_	n w a n ²¹⁴ +
nuàn_	n w a n ⁵¹ +
nuō_	n w ɔ ⁵⁵ +
nuó_	n w ɔ ³⁵ +
nuǒ_	n w ɔ ²¹⁴ +
nuò_	n w ɔ ⁵¹ +
nū_	n u ⁵⁵ +
nú_	n u ³⁵ +
nǔ_	n u ²¹⁴ +
nù_	n u ⁵¹ +
ōu_	ɔu ⁵⁵ +
óu_	ɔu ³⁵ +
ǒu_	ɔu ²¹⁴ +
òu_	ɔu ⁵¹ +
pā_	pʰ a ⁵⁵ +
pá_	pʰ a ³⁵ +
pǎ_	pʰ a ²¹⁴ +
pà_	pʰ a ⁵¹ +
pāi_	pʰ ai ⁵⁵ +
pái_	pʰ ai ³⁵ +
pǎi_	pʰ ai ²¹⁴ +
pài_	pʰ ai ⁵¹ +
pān_	pʰ a n ⁵⁵ +
pán_	pʰ a n ³⁵ +
pǎn_	pʰ a n ²¹⁴ +
pàn_	pʰ a n ⁵¹ +
pāng_	pʰ a ŋ ⁵⁵ +
páng_	pʰ a ŋ ³⁵ +
pǎng_	pʰ a ŋ ²¹⁴ +
pàng_	pʰ a ŋ ⁵¹ +
pāo_	pʰ au ⁵⁵ +
páo_	pʰ au ³⁵ +
pǎo_	pʰ au ²¹⁴ +
pào_	pʰ au ⁵¹ +
peng_	pʰ ə ŋ ⁰ +
pēi_	pʰ əi ⁵⁵ +
péi_	pʰ əi ³⁵ +
pěi_	pʰ əi ²¹⁴ +
pèi_	pʰ əi ⁵¹ +
pēn_	pʰ ə n ⁵⁵ +
pén_	pʰ ə n ³⁵ +
pěn_	pʰ ə n ²¹⁴ +
pèn_	pʰ ə n ⁵¹ +
pēng_	pʰ ə ŋ ⁵⁵ +
péng_	pʰ ə ŋ ³⁵ +
pěng_	pʰ ə ŋ ²¹⁴ +
pèng_	pʰ ə ŋ ⁵¹ +
piān_	pʰ j ɛ n ⁵⁵ +
pián_	pʰ j ɛ n ³⁵ +
piǎn_	pʰ j ɛ n ²¹⁴ +
piàn_	pʰ j ɛ n ⁵¹ +
pī_	pʰ i ⁵⁵ +
pí_	pʰ i ³⁵ +
pǐ_	pʰ i ²¹⁴ +
pì_	pʰ i ⁵¹ +
pīn_	pʰ i n ⁵⁵ +
pín_	pʰ i n ³⁵ +
pǐn_	pʰ i n ²¹⁴ +
pìn_	pʰ i n ⁵¹ +
pīng_	pʰ i ŋ ⁵⁵ +
píng_	pʰ i ŋ ³⁵ +
pǐng_	pʰ i ŋ ²¹⁴ +
pìng_	pʰ i ŋ ⁵¹ +
po_	pʰ w ɔ ⁰ +
pō_	pʰ w ɔ ⁵⁵ +
pó_	pʰ w ɔ ³⁵ +
pǒ_	pʰ w ɔ ²¹⁴ +
pò_	pʰ w ɔ ⁵¹ +
pū_	pʰ u ⁵⁵ +
pú_	pʰ u ³⁵ +
pǔ_	pʰ u ²¹⁴ +
pù_	pʰ u ⁵¹ +
qi_	tɕʰ ⁰ +
qian_	tɕʰ j ɛ n ⁰ +
qiā_	tɕʰ j a ⁵⁵ +
qiá_	tɕʰ j a ³⁵ +
qiǎ_	tɕʰ j a ²¹⁴ +
qià_	tɕʰ j a ⁵¹ +
qiān_	tɕʰ j ɛ n ⁵⁵ +
qián_	tɕʰ j ɛ n ³⁵ +
qiǎn_	tɕʰ j ɛ n ²¹⁴ +
qiàn_	tɕʰ j ɛ n ⁵¹ +
qiāng_	tɕʰ j a ŋ ⁵⁵ +
qiáng_	tɕʰ j a ŋ ³⁵ +
qiǎng_	tɕʰ j a ŋ ²¹⁴ +
qiàng_	tɕʰ j a ŋ ⁵¹ +
qiāo_	tɕʰ j au ⁵⁵ +
qiáo_	tɕʰ j au ³⁵ +
qiǎo_	tɕʰ j au ²¹⁴ +
qiào_	tɕʰ j au ⁵¹ +
qiē_	tɕʰ j ə ⁵⁵ +
qié_	tɕʰ j ə ³⁵ +
qiě_	tɕʰ j ə ²¹⁴ +
qiè_	tɕʰ j ə ⁵¹ +
qin_	tɕʰ i n ⁰ +
qing_	tɕʰ i ŋ ⁰ +
qiōng_	tɕʰ j ʊ ŋ ⁵⁵ +
qióng_	tɕʰ j ʊ ŋ ³⁵ +
qiǒng_	tɕʰ j ʊ ŋ ²¹⁴ +
qiòng_	tɕʰ j ʊ ŋ ⁵¹ +
qiū_	tɕʰ j ɔu ⁵⁵ +
qiú_	tɕʰ j ɔu ³⁵ +
qiǔ_	tɕʰ j ɔu ²¹⁴ +
qiù_	tɕʰ j ɔu ⁵¹ +
qī_	tɕʰ i ⁵⁵ +
qí_	tɕʰ i ³⁵ +
qǐ_	tɕʰ i ²¹⁴ +
qì_	tɕʰ i ⁵¹ +
qīn_	tɕʰ i n ⁵⁵ +
qín_	tɕʰ i n ³⁵ +
qǐn_	tɕʰ i n ²¹⁴ +
qìn_	tɕʰ i n ⁵¹ +
qīng_	tɕʰ i ŋ ⁵⁵ +
qíng_	tɕʰ i ŋ ³⁵ +
qǐng_	tɕʰ i ŋ ²¹⁴ +
qìng_	tɕʰ i ŋ ⁵¹ +
quān_	tɕʰ ɥ ɛ n ⁵⁵ +
quán_	tɕʰ ɥ ɛ n ³⁵ +
quǎn_	tɕʰ ɥ ɛ n ²¹⁴ +
quàn_	tɕʰ ɥ ɛ n ⁵¹ +
quē_	tɕʰ ɥ ə ⁵⁵ +
qué_	tɕʰ ɥ ə ³⁵ +
quě_	tɕʰ ɥ ə ²¹⁴ +
què_	tɕʰ ɥ ə ⁵¹ +
qū_	tɕʰ y ⁵⁵ +
qú_	tɕʰ y ³⁵ +
qǔ_	tɕʰ y ²¹⁴ +
qù_	tɕʰ y ⁵¹ +
qūn_	tɕʰ y n ⁵⁵ +
qún_	tɕʰ y n ³⁵ +
qǔn_	tɕʰ y n ²¹⁴ +
qùn_	tɕʰ y n ⁵¹ +
rān_	ʐ a n ⁵⁵ +
rán_	ʐ a n ³⁵ +
rǎn_	ʐ a n ²¹⁴ +
ràn_	ʐ a n ⁵¹ +
rāo_	ʐ au ⁵⁵ +
ráo_	ʐ au ³⁵ +
rǎo_	ʐ au ²¹⁴ +
rào_	ʐ au ⁵¹ +
rē_	ʐ ə ⁵⁵ +
ré_	ʐ ə ³⁵ +
rě_	ʐ ə ²¹⁴ +
rè_	ʐ ə ⁵¹ +
rēn_	ʐ ə n ⁵⁵ +
rén_	ʐ ə n ³⁵ +
rěn_	ʐ ə n ²¹⁴ +
rèn_	ʐ ə n ⁵¹ +
rēng_	ʐ ə ŋ ⁵⁵ +
réng_	ʐ ə ŋ ³⁵ +
rěng_	ʐ ə ŋ ²¹⁴ +
rèng_	ʐ ə ŋ ⁵¹ +
rī_	ʐ ʅ ⁵⁵ +
rí_	ʐ ʅ ³⁵ +
rǐ_	ʐ ʅ ²¹⁴ +
rì_	ʐ ʅ ⁵¹ +
rōng_	ʐ ʊ ŋ ⁵⁵ +
róng_	ʐ ʊ ŋ ³⁵ +
rǒng_	ʐ ʊ ŋ ²¹⁴ +
ròng_	ʐ ʊ ŋ ⁵¹ +
rōu_	ʐ ɔu ⁵⁵ +
róu_	ʐ ɔu ³⁵ +
rǒu_	ʐ ɔu ²¹⁴ +
ròu_	ʐ ɔu ⁵¹ +
ruān_	ʐ w a n ⁵⁵ +
ruán_	ʐ w a n ³⁵ +
ruǎn_	ʐ w a n ²¹⁴ +
ruàn_	ʐ w a n ⁵¹ +
ruō_	ʐ w ɔ ⁵⁵ +
ruó_	ʐ w ɔ ³⁵ +
ruǒ_	ʐ w ɔ ²¹⁴ +
ruò_	ʐ w ɔ ⁵¹ +
rū_	ʐ u ⁵⁵ +
rú_	ʐ u ³⁵ +
rǔ_	ʐ u ²¹⁴ +
rù_	ʐ u ⁵¹ +
sāi_	s ai ⁵⁵ +
sái_	s ai ³⁵ +
sǎi_	s ai ²¹⁴ +
sài_	s ai ⁵¹ +
sān_	s a n ⁵⁵ +
sán_	s a n ³⁵ +
sǎn_	s a n ²¹⁴ +
sàn_	s a n ⁵¹ +
sāo_	s au ⁵⁵ +
sáo_	s au ³⁵ +
sǎo_	s au ²¹⁴ +
sào_	s au ⁵¹ +
sē_	s ə ⁵⁵ +
sé_	s ə ³⁵ +
sě_	s ə ²¹⁴ +
sè_	s ə ⁵¹ +
sēn_	s ə n ⁵⁵ +
sén_	s ə n ³⁵ +
sěn_	s ə n ²¹⁴ +
sèn_	s ə n ⁵¹ +
shang_	ʂ a ŋ ⁰ +
shā_	ʂ a ⁵⁵ +
shá_	ʂ a ³⁵ +
shǎ_	ʂ a ²¹⁴ +
shà_	ʂ a ⁵¹ +
shāi_	ʂ ai ⁵⁵ +
shái_	ʂ ai ³⁵ +
shǎi_	ʂ ai ²¹⁴ +
shài_	ʂ ai ⁵¹ +
shān_	ʂ a n ⁵⁵ +
shán_	ʂ a n ³⁵ +
shǎn_	ʂ a n ²¹⁴ +
shàn_	ʂ a n ⁵¹ +
shāng_	ʂ a ŋ ⁵⁵ +
sháng_	ʂ a ŋ ³⁵ +
shǎng_	ʂ a ŋ ²¹⁴ +
shàng_	ʂ a ŋ ⁵¹ +
shāo_	ʂ au ⁵⁵ +
sháo_	ʂ au ³⁵ +
shǎo_	ʂ au ²¹⁴ +
shào_	ʂ au ⁵¹ +
sheng_	ʂ ə ŋ ⁰ +
shē_	ʂ ə ⁵⁵ +
shé_	ʂ ə ³⁵ +
shě_	ʂ ə ²¹⁴ +
shè_	ʂ ə ⁵¹ +
shēn_	ʂ ə n ⁵⁵ +
shén_	ʂ ə n ³⁵ +
shěn_	ʂ ə n ²¹⁴ +
shèn_	ʂ ə n ⁵¹ +
shēng_	ʂ ə ŋ ⁵⁵ +
shéng_	ʂ ə ŋ ³⁵ +
shěng_	ʂ ə ŋ ²¹⁴ +
shèng_	ʂ ə ŋ ⁵¹ +
shēnɡ_	ʂ ə ŋ ⁵⁵ +
shénɡ_	ʂ ə ŋ ³⁵ +
shěnɡ_	ʂ ə ŋ ²¹⁴ +
shènɡ_	ʂ ə ŋ ⁵¹ +
shi_	ʂ ʅ ⁰ +
shī_	ʂ ʅ ⁵⁵ +
shí_	ʂ ʅ ³⁵ +
shǐ_	ʂ ʅ ²¹⁴ +
shì_	ʂ ʅ ⁵¹ +
shōu_	ʂ ɔu ⁵⁵ +
shóu_	ʂ ɔu ³⁵ +
shǒu_	ʂ ɔu ²¹⁴ +
shòu_	ʂ ɔu ⁵¹ +
shuā_	ʂ w a ⁵⁵ +
shuá_	ʂ w a ³⁵ +
shuǎ_	ʂ w a ²¹⁴ +
shuà_	ʂ w a ⁵¹ +
shuān_	ʂ w a n ⁵⁵ +
shuán_	ʂ w a n ³⁵ +
shuǎn_	ʂ w a n ²¹⁴ +
shuàn_	ʂ w a n ⁵¹ +
shuāng_	ʂ w a ŋ ⁵⁵ +
shuáng_	ʂ w a ŋ ³⁵ +
shuǎng_	ʂ w a ŋ ²¹⁴ +
shuàng_	ʂ w a ŋ ⁵¹ +
shuī_	ʂ w əi ⁵⁵ +
shuí_	ʂ w əi ³⁵ +
shuǐ_	ʂ w əi ²¹⁴ +
shuì_	ʂ w əi ⁵¹ +
shuō_	ʂ w ɔ ⁵⁵ +
shuó_	ʂ w ɔ ³⁵ +
shuǒ_	ʂ w ɔ ²¹⁴ +
shuò_	ʂ w ɔ ⁵¹ +
shū_	ʂ u ⁵⁵ +
shú_	ʂ u ³⁵ +
shǔ_	ʂ u ²¹⁴ +
shù_	ʂ u ⁵¹ +
sī_	s ɿ ⁵⁵ +
sí_	s ɿ ³⁵ +
sǐ_	s ɿ ²¹⁴ +
sì_	s ɿ ⁵¹ +
sōng_	s ʊ ŋ ⁵⁵ +
sóng_	s ʊ ŋ ³⁵ +
sǒng_	s ʊ ŋ ²¹⁴ +
sòng_	s ʊ ŋ ⁵¹ +
suān_	s w a n ⁵⁵ +
suán_	s w a n ³⁵ +
suǎn_	s w a n ²¹⁴ +
suàn_	s w a n ⁵¹ +
suī_	s w əi ⁵⁵ +
suí_	s w əi ³⁵ +
suǐ_	s w əi ²¹⁴ +
suì_	s w əi ⁵¹ +
suō_	s w ɔ ⁵⁵ +
suó_	s w ɔ ³⁵ +
suǒ_	s w ɔ ²¹⁴ +
suò_	s w ɔ ⁵¹ +
sū_	s u ⁵⁵ +
sú_	s u ³⁵ +
sǔ_	s u ²¹⁴ +
sù_	s u ⁵¹ +
sūn_	s ʊ n ⁵⁵ +
sún_	s ʊ n ³⁵ +
sǔn_	s ʊ n ²¹⁴ +
sùn_	s ʊ n ⁵¹ +
tao_	tʰ au ⁰ +
tā_	tʰ a ⁵⁵ +
tá_	tʰ a ³⁵ +
tǎ_	tʰ a ²¹⁴ +
tà_	tʰ a ⁵¹ +
tāi_	tʰ ai ⁵⁵ +
tái_	tʰ ai ³⁵ +
tǎi_	tʰ ai ²¹⁴ +
tài_	tʰ ai ⁵¹ +
tān_	tʰ a n ⁵⁵ +
tán_	tʰ a n ³⁵ +
tǎn_	tʰ a n ²¹⁴ +
tàn_	tʰ a n ⁵¹ +
tāng_	tʰ a ŋ ⁵⁵ +
táng_	tʰ a ŋ ³⁵ +
tǎng_	tʰ a ŋ ²¹⁴ +
tàng_	tʰ a ŋ ⁵¹ +
tāo_	tʰ au ⁵⁵ +
táo_	tʰ au ³⁵ +
tǎo_	tʰ au ²¹⁴ +
tào_	tʰ au ⁵¹ +
tēng_	tʰ ə ŋ ⁵⁵ +
téng_	tʰ ə ŋ ³⁵ +
těng_	tʰ ə ŋ ²¹⁴ +
tèng_	tʰ ə ŋ ⁵¹ +
tiān_	tʰ j ɛ n ⁵⁵ +
tián_	tʰ j ɛ n ³⁵ +
tiǎn_	tʰ j ɛ n ²¹⁴ +
tiàn_	tʰ j ɛ n ⁵¹ +
tiāo_	tʰ j au ⁵⁵ +
tiáo_	tʰ j au ³⁵ +
tiǎo_	tʰ j au ²¹⁴ +
tiào_	tʰ j au ⁵¹ +
tiē_	tʰ j ə ⁵⁵ +
tié_	tʰ j ə ³⁵ +
tiě_	tʰ j ə ²¹⁴ +
tiè_	tʰ j ə ⁵¹ +
tī_	tʰ i ⁵⁵ +
tí_	tʰ i ³⁵ +
tǐ_	tʰ i ²¹⁴ +
tì_	tʰ i ⁵¹ +
tīng_	tʰ i ŋ ⁵⁵ +
tíng_	tʰ i ŋ ³⁵ +
tǐng_	tʰ i ŋ ²¹⁴ +
tìng_	tʰ i ŋ ⁵¹ +
tou_	tʰ ɔu ⁰ +
tōng_	tʰ ʊ ŋ ⁵⁵ +
tóng_	tʰ ʊ ŋ ³⁵ +
tǒng_	tʰ ʊ ŋ ²¹⁴ +
tòng_	tʰ ʊ ŋ ⁵¹ +
tōu_	tʰ ɔu ⁵⁵ +
tóu_	tʰ ɔu ³⁵ +
tǒu_	tʰ ɔu ²¹⁴ +
tòu_	tʰ ɔu ⁵¹ +
tuān_	tʰ w a n ⁵⁵ +
tuán_	tʰ w a n ³⁵ +
tuǎn_	tʰ w a n ²¹⁴ +
tuàn_	tʰ w a n ⁵¹ +
tuī_	tʰ w əi ⁵⁵ +
tuí_	tʰ w əi ³⁵ +
tuǐ_	tʰ w əi ²¹⁴ +
tuì_	tʰ w əi ⁵¹ +
tuo_	tʰ w ɔ ⁰ +
tuō_	tʰ w ɔ ⁵⁵ +
tuó_	tʰ w ɔ ³⁵ +
tuǒ_	tʰ w ɔ ²¹⁴ +
tuò_	tʰ w ɔ ⁵¹ +
tū_	tʰ u ⁵⁵ +
tú_	tʰ u ³⁵ +
tǔ_	tʰ u ²¹⁴ +
tù_	tʰ u ⁵¹ +
tūn_	tʰ ʊ n ⁵⁵ +
tún_	tʰ ʊ n ³⁵ +
tǔn_	tʰ ʊ n ²¹⁴ +
tùn_	tʰ ʊ n ⁵¹ +
wā_	w a ⁵⁵ +
wá_	w a ³⁵ +
wǎ_	w a ²¹⁴ +
wà_	w a ⁵¹ +
wāi_	w ai ⁵⁵ +
wái_	w ai ³⁵ +
wǎi_	w ai ²¹⁴ +
wài_	w ai ⁵¹ +
wān_	w a n ⁵⁵ +
wán_	w a n ³⁵ +
wǎn_	w a n ²¹⁴ +
wàn_	w a n ⁵¹ +
wāng_	w a ŋ ⁵⁵ +
wáng_	w a ŋ ³⁵ +
wǎng_	w a ŋ ²¹⁴ +
wàng_	w a ŋ ⁵¹ +
wēi_	w əi ⁵⁵ +
wéi_	w əi ³⁵ +
wěi_	w əi ²¹⁴ +
wèi_	w əi ⁵¹ +
wēn_	w ə n ⁵⁵ +
wén_	w ə n ³⁵ +
wěn_	w ə n ²¹⁴ +
wèn_	w ə n ⁵¹ +
wō_	w ɔ ⁵⁵ +
wó_	w ɔ ³⁵ +
wǒ_	w ɔ ²¹⁴ +
wò_	w ɔ ⁵¹ +
wū_	w u ⁵⁵ +
wú_	w u ³⁵ +
wǔ_	w u ²¹⁴ +
wù_	w u ⁵¹ +
xi_	ɕ i ⁰ +
xiā_	ɕ j a ⁵⁵ +
xiá_	ɕ j a ³⁵ +
xiǎ_	ɕ j a ²¹⁴ +
xià_	ɕ j a ⁵¹ +
xiān_	ɕ j ɛ n ⁵⁵ +
xián_	ɕ j ɛ n ³⁵ +
xiǎn_	ɕ j ɛ n ²¹⁴ +
xiàn_	ɕ j ɛ n ⁵¹ +
xiāng_	ɕ j a ŋ ⁵⁵ +
xiáng_	ɕ j a ŋ ³⁵ +
xiǎng_	ɕ j a ŋ ²¹⁴ +
xiàng_	ɕ j a ŋ ⁵¹ +
xiāo_	ɕ j au ⁵⁵ +
xiáo_	ɕ j au ³⁵ +
xiǎo_	ɕ j au ²¹⁴ +
xiào_	ɕ j au ⁵¹ +
xiē_	ɕ j ə ⁵⁵ +
xié_	ɕ j ə ³⁵ +
xiě_	ɕ j ə ²¹⁴ +
xiè_	ɕ j ə ⁵¹ +
xiōng_	ɕ j ʊ ŋ ⁵⁵ +
xióng_	ɕ j ʊ ŋ ³⁵ +
xiǒng_	ɕ j ʊ ŋ ²¹⁴ +
xiòng_	ɕ j ʊ ŋ ⁵¹ +
xiū_	ɕ j ɔu ⁵⁵ +
xiú_	ɕ j ɔu ³⁵ +
xiǔ_	ɕ j ɔu ²¹⁴ +
xiù_	ɕ j ɔu ⁵¹ +
xī_	ɕ i ⁵⁵ +
xí_	ɕ i ³⁵ +
xǐ_	ɕ i ²¹⁴ +
xì_	ɕ i ⁵¹ +
xīn_	ɕ i n ⁵⁵ +
xín_	ɕ i n ³⁵ +
xǐn_	ɕ i n ²¹⁴ +
xìn_	ɕ i n ⁵¹ +
xīng_	ɕ i ŋ ⁵⁵ +
xíng_	ɕ i ŋ ³⁵ +
xǐng_	ɕ i ŋ ²¹⁴ +
xìng_	ɕ i ŋ ⁵¹ +
xu_	ɕ y ⁰ +
xuān_	ɕ ɥ ɛ n ⁵⁵ +
xuán_	ɕ ɥ ɛ n ³⁵ +
xuǎn_	ɕ ɥ ɛ n ²¹⁴ +
xuàn_	ɕ ɥ ɛ n ⁵¹ +
xuē_	ɕ ɥ ə ⁵⁵ +
xué_	ɕ ɥ ə ³⁵ +
xuě_	ɕ ɥ ə ²¹⁴ +
xuè_	ɕ ɥ ə ⁵¹ +
xū_	ɕ y ⁵⁵ +
xú_	ɕ y ³⁵ +
xǔ_	ɕ y ²¹⁴ +
xù_	ɕ y ⁵¹ +
xūn_	ɕ y n ⁵⁵ +
xún_	ɕ y n ³⁵ +
xǔn_	ɕ y n ²¹⁴ +
xùn_	ɕ y n ⁵¹ +
yā_	j a ⁵⁵ +
yá_	j a ³⁵ +
yǎ_	j a ²¹⁴ +
yà_	j a ⁵¹ +
yān_	j a n ⁵⁵ +
yán_	j a n ³⁵ +
yǎn_	j a n ²¹⁴ +
yàn_	j a n ⁵¹ +
yāng_	j a ŋ ⁵⁵ +
yáng_	j a ŋ ³⁵ +
yǎng_	j a ŋ ²¹⁴ +
yàng_	j a ŋ ⁵¹ +
yāo_	j au ⁵⁵ +
yáo_	j au ³⁵ +
yǎo_	j au ²¹⁴ +
yào_	j au ⁵¹ +
yē_	j ə ⁵⁵ +
yé_	j ə ³⁵ +
yě_	j ə ²¹⁴ +
yè_	j ə ⁵¹ +
yi_	j i ⁰ +
ying_	j i ŋ ⁰ +
yī_	j i ⁵⁵ +
yí_	j i ³⁵ +
yǐ_	j i ²¹⁴ +
yì_	j i ⁵¹ +
yīn_	j i n ⁵⁵ +
yín_	j i n ³⁵ +
yǐn_	j i n ²¹⁴ +
yìn_	j i n ⁵¹ +
yīng_	j i ŋ ⁵⁵ +
yíng_	j i ŋ ³⁵ +
yǐng_	j i ŋ ²¹⁴ +
yìng_	j i ŋ ⁵¹ +
you_	j ɔu ⁰ +
yōng_	j ʊ ŋ ⁵⁵ +
yóng_	j ʊ ŋ ³⁵ +
yǒng_	j ʊ ŋ ²¹⁴ +
yòng_	j ʊ ŋ ⁵¹ +
yōu_	j ɔu ⁵⁵ +
yóu_	j ɔu ³⁵ +
yǒu_	j ɔu ²¹⁴ +
yòu_	j ɔu ⁵¹ +
yuān_	ɥ ɛ n ⁵⁵ +
yuán_	ɥ ɛ n ³⁵ +
yuǎn_	ɥ ɛ n ²¹⁴ +
yuàn_	ɥ ɛ n ⁵¹ +
yuē_	ɥ ə ⁵⁵ +
yué_	ɥ ə ³⁵ +
yuě_	ɥ ə ²¹⁴ +
yuè_	ɥ ə ⁵¹ +
yū_	ɥ y ⁵⁵ +
yú_	ɥ y ³⁵ +
yǔ_	ɥ y ²¹⁴ +
yù_	ɥ y ⁵¹ +
yūn_	ɥ y n ⁵⁵ +
yún_	ɥ y n ³⁵ +
yǔn_	ɥ y n ²¹⁴ +
yùn_	ɥ y n ⁵¹ +
zao_	ts au ⁰ +
zāi_	ts ai ⁵⁵ +
zái_	ts ai ³⁵ +
zǎi_	ts ai ²¹⁴ +
zài_	ts ai ⁵¹ +
zān_	ts a n ⁵⁵ +
zán_	ts a n ³⁵ +
zǎn_	ts a n ²¹⁴ +
zàn_	ts a n ⁵¹ +
zāng_	ts a ŋ ⁵⁵ +
záng_	ts a ŋ ³⁵ +
zǎng_	ts a ŋ ²¹⁴ +
zàng_	ts a ŋ ⁵¹ +
zāo_	ts au ⁵⁵ +
záo_	ts au ³⁵ +
zǎo_	ts au ²¹⁴ +
zào_	ts au ⁵¹ +
zē_	ts ə ⁵⁵ +
zé_	ts ə ³⁵ +
zě_	ts ə ²¹⁴ +
zè_	ts ə ⁵¹ +
zhā_	ʈʂ a ⁵⁵ +
zhá_	ʈʂ a ³⁵ +
zhǎ_	ʈʂ a ²¹⁴ +
zhà_	ʈʂ a ⁵¹ +
zhāi_	ʈʂ ai ⁵⁵ +
zhái_	ʈʂ ai ³⁵ +
zhǎi_	ʈʂ ai ²¹⁴ +
zhài_	ʈʂ ai ⁵¹ +
zhān_	ʈʂ a n ⁵⁵ +
zhán_	ʈʂ a n ³⁵ +
zhǎn_	ʈʂ a n ²¹⁴ +
zhàn_	ʈʂ a n ⁵¹ +
zhāng_	ʈʂ a ŋ ⁵⁵ +
zháng_	ʈʂ a ŋ ³⁵ +
zhǎng_	ʈʂ a ŋ ²¹⁴ +
zhàng_	ʈʂ a ŋ ⁵¹ +
zhāo_	ʈʂ au ⁵⁵ +
zháo_	ʈʂ au ³⁵ +
zhǎo_	ʈʂ au ²¹⁴ +
zhào_	ʈʂ au ⁵¹ +
zhe_	ʈʂ ə ⁰ +
zhē_	ʈʂ ə ⁵⁵ +
zhé_	ʈʂ ə ³⁵ +
zhě_	ʈʂ ə ²¹⁴ +
zhè_	ʈʂ ə ⁵¹ +
zhēn_	ʈʂ ə n ⁵⁵ +
zhén_	ʈʂ ə n ³⁵ +
zhěn_	ʈʂ ə n ²¹⁴ +
zhèn_	ʈʂ ə n ⁵¹ +
zhēng_	ʈʂ ə ŋ ⁵⁵ +
zhéng_	ʈʂ ə ŋ ³⁵ +
zhěng_	ʈʂ ə ŋ ²¹⁴ +
zhèng_	ʈʂ ə ŋ ⁵¹ +
zhi_	ʈʂ ʅ ⁰ +
zhī_	ʈʂ ʅ ⁵⁵ +
zhí_	ʈʂ ʅ ³⁵ +
zhǐ_	ʈʂ ʅ ²¹⁴ +
zhì_	ʈʂ ʅ ⁵¹ +
zhou_	ʈʂ ɔu ⁰ +
zhōng_	ʈʂ ʊ ŋ ⁵⁵ +
zhóng_	ʈʂ ʊ ŋ ³⁵ +
zhǒng_	ʈʂ ʊ ŋ ²¹⁴ +
zhòng_	ʈʂ ʊ ŋ ⁵¹ +
zhōu_	ʈʂ ɔu ⁵⁵ +
zhóu_	ʈʂ ɔu ³⁵ +
zhǒu_	ʈʂ ɔu ²¹⁴ +
zhòu_	ʈʂ ɔu ⁵¹ +
zhuā_	ʈʂ w a ⁵⁵ +
zhuá_	ʈʂ w a ³⁵ +
zhuǎ_	ʈʂ w a ²¹⁴ +
zhuà_	ʈʂ w a ⁵¹ +
zhuān_	ʈʂ w a n ⁵⁵ +
zhuán_	ʈʂ w a n ³⁵ +
zhuǎn_	ʈʂ w a n ²¹⁴ +
zhuàn_	ʈʂ w a n ⁵¹ +
zhuāng_	ʈʂ w a ŋ ⁵⁵ +
zhuáng_	ʈʂ w a ŋ ³⁵ +
zhuǎng_	ʈʂ w a ŋ ²¹⁴ +
zhuàng_	ʈʂ w a ŋ ⁵¹ +
zhuī_	ʈʂ w əi ⁵⁵ +
zhuí_	ʈʂ w əi ³⁵ +
zhuǐ_	ʈʂ w əi ²¹⁴ +
zhuì_	ʈʂ w əi ⁵¹ +
zhuō_	ʈʂ w ɔ ⁵⁵ +
zhuó_	ʈʂ w ɔ ³⁵ +
zhuǒ_	ʈʂ w ɔ ²¹⁴ +
zhuò_	ʈʂ w ɔ ⁵¹ +
zhū_	ʈʂ u ⁵⁵ +
zhú_	ʈʂ u ³⁵ +
zhǔ_	ʈʂ u ²¹⁴ +
zhù_	ʈʂ u ⁵¹ +
zhūn_	ʈʂ ʊ n ⁵⁵ +
zhún_	ʈʂ ʊ n ³⁵ +
zhǔn_	ʈʂ ʊ n ²¹⁴ +
zhùn_	ʈʂ ʊ n ⁵¹ +
zi_	ts ɿ ⁰ +
zī_	ts ɿ ⁵⁵ +
zí_	ts ɿ ³⁵ +
zǐ_	ts ɿ ²¹⁴ +
zì_	ts ɿ ⁵¹ +
zōng_	ts ʊ ŋ ⁵⁵ +
zóng_	ts ʊ ŋ ³⁵ +
zǒng_	ts ʊ ŋ ²¹⁴ +
zòng_	ts ʊ ŋ ⁵¹ +
zōu_	ts ɔu ⁵⁵ +
zóu_	ts ɔu ³⁵ +
zǒu_	ts ɔu ²¹⁴ +
zòu_	ts ɔu ⁵¹ +
zuān_	ts w a n ⁵⁵ +
zuán_	ts w a n ³⁵ +
zuǎn_	ts w a n ²¹⁴ +
zuàn_	ts w a n ⁵¹ +
zuī_	ts w əi ⁵⁵ +
zuí_	ts w əi ³⁵ +
zuǐ_	ts w əi ²¹⁴ +
zuì_	ts w əi ⁵¹ +
zuō_	ts w ɔ ⁵⁵ +
zuó_	ts w ɔ ³⁵ +
zuǒ_	ts w ɔ ²¹⁴ +
zuò_	ts w ɔ ⁵¹ +
zū_	ts u ⁵⁵ +
zú_	ts u ³⁵ +
zǔ_	ts u ²¹⁴ +
zù_	ts u ⁵¹ +
āi	ai ⁵⁵ +
ái	ai ³⁵ +
ǎi	ai ²¹⁴ +
ài	ai ⁵¹ +
ān	a n ⁵⁵ +
án	a n ³⁵ +
ǎn	a n ²¹⁴ +
àn	a n ⁵¹ +
āng	a ŋ ⁵⁵ +
áng	a ŋ ³⁵ +
ǎng	a ŋ ²¹⁴ +
àng	a ŋ ⁵¹ +
āo	au ⁵⁵ +
áo	au ³⁵ +
ǎo	au ²¹⁴ +
ào	au ⁵¹ +
ba	p a ⁰ +
bā	p a ⁵⁵ +
bá	p a ³⁵ +
bǎ	p a ²¹⁴ +
bà	p a ⁵¹ +
bāi	p ai ⁵⁵ +
bái	p ai ³⁵ +
bǎi	p ai ²¹⁴ +
bài	p ai ⁵¹ +
bān	p a n ⁵⁵ +
bán	p a n ³⁵ +
bǎn	p a n ²¹⁴ +
bàn	p a n ⁵¹ +
bāng	p a ŋ ⁵⁵ +
báng	p a ŋ ³⁵ +
bǎng	p a ŋ ²¹⁴ +
bàng	p a ŋ ⁵¹ +
bāo	p au ⁵⁵ +
báo	p au ³⁵ +
bǎo	p au ²¹⁴ +
bào	p au ⁵¹ +
bēi	p ei ⁵⁵ +
béi	p ei ³⁵ +
běi	p ei ²¹⁴ +
bèi	p ei ⁵¹ +
bēn	p e n ⁵⁵ +
bén	p e n ³⁵ +
běn	p e n ²¹⁴ +
bèn	p e n ⁵¹ +
biān	p j ɛ n ⁵⁵ +
bián	p j ɛ n ³⁵ +
biǎn	p j ɛ n ²¹⁴ +
biàn	p j ɛ n ⁵¹ +
biāo	p j au ⁵⁵ +
biáo	p j au ³⁵ +
biǎo	p j au ²¹⁴ +
biào	p j au ⁵¹ +
biē	p j ɛ ⁵⁵ +
bié	p j ɛ ³⁵ +
biě	p j ɛ ²¹⁴ +
biè	p j ɛ ⁵¹ +
bī	p i ⁵⁵ +
bí	p i ³⁵ +
bǐ	p i ²¹⁴ +
bì	p i ⁵¹ +
bīn	p i n ⁵⁵ +
bín	p i n ³⁵ +
bǐn	p i n ²¹⁴ +
bìn	p i n ⁵¹ +
bīng	p i ŋ ⁵⁵ +
bíng	p i ŋ ³⁵ +
bǐng	p i ŋ ²¹⁴ +
bìng	p i ŋ ⁵¹ +
bo	p w o ⁰ +
bō	p w o ⁵⁵ +
bó	p w o ³⁵ +
bǒ	p w o ²¹⁴ +
bò	p w o ⁵¹ +
bū	p u ⁵⁵ +
bú	p u ³⁵ +
bǔ	p u ²¹⁴ +
bù	p u ⁵¹ +
cā	tsʰ a ⁵⁵ +
cá	tsʰ a ³⁵ +
cǎ	tsʰ a ²¹⁴ +
cà	tsʰ a ⁵¹ +
cāi	tsʰ ai ⁵⁵ +
cái	tsʰ ai ³⁵ +
cǎi	tsʰ ai ²¹⁴ +
cài	tsʰ ai ⁵¹ +
cān	tsʰ a n ⁵⁵ +
cán	tsʰ a n ³⁵ +
cǎn	tsʰ a n ²¹⁴ +
càn	tsʰ a n ⁵¹ +
cāng	tsʰ a ŋ ⁵⁵ +
cáng	tsʰ a ŋ ³⁵ +
cǎng	tsʰ a ŋ ²¹⁴ +
càng	tsʰ a ŋ ⁵¹ +
cāo	tsʰ au ⁵⁵ +
cáo	tsʰ au ³⁵ +
cǎo	tsʰ au ²¹⁴ +
cào	tsʰ au ⁵¹ +
cē	tsʰ ə ⁵⁵ +
cé	tsʰ ə ³⁵ +
cě	tsʰ ə ²¹⁴ +
cè	tsʰ ə ⁵¹ +
chā	ʈʂʰ a ⁵⁵ +
chá	ʈʂʰ a ³⁵ +
chǎ	ʈʂʰ a ²¹⁴ +
chà	ʈʂʰ a ⁵¹ +
chāi	ʈʂʰ ai ⁵⁵ +
chái	ʈʂʰ ai ³⁵ +
chǎi	ʈʂʰ ai ²¹⁴ +
chài	ʈʂʰ ai ⁵¹ +
chān	ʈʂʰ a n ⁵⁵ +
chán	ʈʂʰ a n ³⁵ +
chǎn	ʈʂʰ a n ²¹⁴ +
chàn	ʈʂʰ a n ⁵¹ +
chāng	ʈʂ a ŋ ⁵⁵ +
cháng	ʈʂ a ŋ ³⁵ +
chǎng	ʈʂ a ŋ ²¹⁴ +
chàng	ʈʂ a ŋ ⁵¹ +
chāo	ʈʂ au ⁵⁵ +
cháo	ʈʂ au ³⁵ +
chǎo	ʈʂ au ²¹⁴ +
chào	ʈʂ au ⁵¹ +
chen	ʈʂ ə n ⁰ +
chē	ʈʂ ə ⁵⁵ +
ché	ʈʂ ə ³⁵ +
chě	ʈʂ ə ²¹⁴ +
chè	ʈʂ ə ⁵¹ +
chēn	ʈʂ ə n ⁵⁵ +
chén	ʈʂ ə n ³⁵ +
chěn	ʈʂ ə n ²¹⁴ +
chèn	ʈʂ ə n ⁵¹ +
chēng	ʈʂ ə ŋ ⁵⁵ +
chéng	ʈʂ ə ŋ ³⁵ +
chěng	ʈʂ ə ŋ ²¹⁴ +
chèng	ʈʂ ə ŋ ⁵¹ +
chī	ʈʂ ʅ ⁵⁵ +
chí	ʈʂ ʅ ³⁵ +
chǐ	ʈʂ ʅ ²¹⁴ +
chì	ʈʂ ʅ ⁵¹ +
chōng	ʈʂ ʊ ŋ ⁵⁵ +
chóng	ʈʂ ʊ ŋ ³⁵ +
chǒng	ʈʂ ʊ ŋ ²¹⁴ +
chòng	ʈʂ ʊ ŋ ⁵¹ +
chōu	ʈʂ ɔu ⁵⁵ +
chóu	ʈʂ ɔu ³⁵ +
chǒu	ʈʂ ɔu ²¹⁴ +
chòu	ʈʂ ɔu ⁵¹ +
chu	ʈʂ u ⁰ +
chuān	ʈʂ w a n ⁵⁵ +
chuán	ʈʂ w a n ³⁵ +
chuǎn	ʈʂ w a n ²¹⁴ +
chuàn	ʈʂ w a n ⁵¹ +
chuāng	ʈʂ w a ŋ ⁵⁵ +
chuáng	ʈʂ w a ŋ ³⁵ +
chuǎng	ʈʂ w a ŋ ²¹⁴ +
chuàng	ʈʂ w a ŋ ⁵¹ +
chuī	ʈʂ w əi ⁵⁵ +
chuí	ʈʂ w əi ³⁵ +
chuǐ	ʈʂ w əi ²¹⁴ +
chuì	ʈʂ w əi ⁵¹ +
chū	ʈʂ u ⁵⁵ +
chú	ʈʂ u ³⁵ +
chǔ	ʈʂ u ²¹⁴ +
chù	ʈʂ u ⁵¹ +
chūn	ʈʂ u n ⁵⁵ +
chún	ʈʂ u n ³⁵ +
chǔn	ʈʂ u n ²¹⁴ +
chùn	ʈʂ u n ⁵¹ +
cī	tsʰ ɿ ⁵⁵ +
cí	tsʰ ɿ ³⁵ +
cǐ	tsʰ ɿ ²¹⁴ +
cì	tsʰ ɿ ⁵¹ +
cōng	tsʰ ʊ ŋ ⁵⁵ +
cóng	tsʰ ʊ ŋ ³⁵ +
cǒng	tsʰ ʊ ŋ ²¹⁴ +
còng	tsʰ ʊ ŋ ⁵¹ +
cuō	tsʰ w ɔ ⁵⁵ +
cuó	tsʰ w ɔ ³⁵ +
cuǒ	tsʰ w ɔ ²¹⁴ +
cuò	tsʰ w ɔ ⁵¹ +
cū	tsʰ u ⁵⁵ +
cú	tsʰ u ³⁵ +
cǔ	tsʰ u ²¹⁴ +
cù	tsʰ u ⁵¹ +
cūn	tsʰ u n ⁵⁵ +
cún	tsʰ u n ³⁵ +
cǔn	tsʰ u n ²¹⁴ +
cùn	tsʰ u n ⁵¹ +
dā	t a ⁵⁵ +
dá	t a ³⁵ +
dǎ	t a ²¹⁴ +
dà	t a ⁵¹ +
dāi	t ai ⁵⁵ +
dái	t ai ³⁵ +
dǎi	t ai ²¹⁴ +
dài	t ai ⁵¹ +
dān	t a n ⁵⁵ +
dán	t a n ³⁵ +
dǎn	t a n ²¹⁴ +
dàn	t a n ⁵¹ +
dāo	t au ⁵⁵ +
dáo	t au ³⁵ +
dǎo	t au ²¹⁴ +
dào	t au ⁵¹ +
de	t ə ⁰ +
dē	t ə ⁵⁵ +
dé	t ə ³⁵ +
dě	t ə ²¹⁴ +
dè	t ə ⁵¹ +
dēng	t ə ŋ ⁵⁵ +
déng	t ə ŋ ³⁵ +
děng	t ə ŋ ²¹⁴ +
dèng	t ə ŋ ⁵¹ +
di	t i ⁰ +
diān	t j ɛ n ⁵⁵ +
dián	t j ɛ n ³⁵ +
diǎn	t j ɛ n ²¹⁴ +
diàn	t j ɛ n ⁵¹ +
diāo	t j au ⁵⁵ +
diáo	t j au ³⁵ +
diǎo	t j au ²¹⁴ +
diào	t j au ⁵¹ +
diē	t j ə ⁵⁵ +
dié	t j ə ³⁵ +
diě	t j ə ²¹⁴ +
diè	t j ə ⁵¹ +
dī	t i ⁵⁵ +
dí	t i ³⁵ +
dǐ	t i ²¹⁴ +
dì	t i ⁵¹ +
dīng	t i ŋ ⁵⁵ +
díng	t i ŋ ³⁵ +
dǐng	t i ŋ ²¹⁴ +
dìng	t i ŋ ⁵¹ +
dōng	t ʊ ŋ ⁵⁵ +
dóng	t ʊ ŋ ³⁵ +
dǒng	t ʊ ŋ ²¹⁴ +
dòng	t ʊ ŋ ⁵¹ +
dōu	t ɔu ⁵⁵ +
dóu	t ɔu ³⁵ +
dǒu	t ɔu ²¹⁴ +
dòu	t ɔu ⁵¹ +
duān	t w a n ⁵⁵ +
duán	t w a n ³⁵ +
duǎn	t w a n ²¹⁴ +
duàn	t w a n ⁵¹ +
duī	t w əi ⁵⁵ +
duí	t w əi ³⁵ +
duǐ	t w əi ²¹⁴ +
duì	t w əi ⁵¹ +
duo	t w ɔ ⁰ +
duō	t w ɔ ⁵⁵ +
duó	t w ɔ ³⁵ +
duǒ	t w ɔ ²¹⁴ +
duò	t w ɔ ⁵¹ +
dū	t u ⁵⁵ +
dú	t u ³⁵ +
dǔ	t u ²¹⁴ +
dù	t u ⁵¹ +
dūn	t ʊ n ⁵⁵ +
dún	t ʊ n ³⁵ +
dǔn	t ʊ n ²¹⁴ +
dùn	t ʊ n ⁵¹ +
e	ə ⁰ +
ē	ə ⁵⁵ +
é	ə ³⁵ +
ě	ə ²¹⁴ +
è	ə ⁵¹ +
ēr	ɚ ⁵⁵ +
ér	ɚ ³⁵ +
ěr	ɚ ²¹⁴ +
èr	ɚ ⁵¹ +
fa	f a ⁰ +
fā	f a ⁵⁵ +
fá	f a ³⁵ +
fǎ	f a ²¹⁴ +
fà	f a ⁵¹ +
fān	f a n ⁵⁵ +
fán	f a n ³⁵ +
fǎn	f a n ²¹⁴ +
fàn	f a n ⁵¹ +
fāng	f a ŋ ⁵⁵ +
fáng	f a ŋ ³⁵ +
fǎng	f a ŋ ²¹⁴ +
fàng	f a ŋ ⁵¹ +
fen	f ə n ⁰ +
feng	f ə ŋ ⁰ +
fēi	f əi ⁵⁵ +
féi	f əi ³⁵ +
fěi	f əi ²¹⁴ +
fèi	f əi ⁵¹ +
fēn	f ə n ⁵⁵ +
fén	f ə n ³⁵ +
fěn	f ə n ²¹⁴ +
fèn	f ə n ⁵¹ +
fēng	f ə ŋ ⁵⁵ +
féng	f ə ŋ ³⁵ +
fěng	f ə ŋ ²¹⁴ +
fèng	f ə ŋ ⁵¹ +
fōu	f ɔu ⁵⁵ +
fóu	f ɔu ³⁵ +
fǒu	f ɔu ²¹⁴ +
fòu	f ɔu ⁵¹ +
fu	f u ⁰ +
fū	f u ⁵⁵ +
fú	f u ³⁵ +
fǔ	f u ²¹⁴ +
fù	f u ⁵¹ +
gāi	k ai ⁵⁵ +
gái	k ai ³⁵ +
gǎi	k ai ²¹⁴ +
gài	k ai ⁵¹ +
gān	k a n ⁵⁵ +
gán	k a n ³⁵ +
gǎn	k a n ²¹⁴ +
gàn	k a n ⁵¹ +
gāng	k a ŋ ⁵⁵ +
gáng	k a ŋ ³⁵ +
gǎng	k a ŋ ²¹⁴ +
gàng	k a ŋ ⁵¹ +
gāo	k au ⁵⁵ +
gáo	k au ³⁵ +
gǎo	k au ²¹⁴ +
gào	k au ⁵¹ +
ge	k ə ⁰ +
gē	k ə ⁵⁵ +
gé	k ə ³⁵ +
gě	k ə ²¹⁴ +
gè	k ə ⁵¹ +
gēi	k əi ⁵⁵ +
géi	k əi ³⁵ +
gěi	k əi ²¹⁴ +
gèi	k əi ⁵¹ +
gēn	k ə n ⁵⁵ +
gén	k ə n ³⁵ +
gěn	k ə n ²¹⁴ +
gèn	k ə n ⁵¹ +
gēng	k ə ŋ ⁵⁵ +
géng	k ə ŋ ³⁵ +
gěng	k ə ŋ ²¹⁴ +
gèng	k ə ŋ ⁵¹ +
gong	k ʊ ŋ ⁰ +
gōng	k ʊ ŋ ⁵⁵ +
góng	k ʊ ŋ ³⁵ +
gǒng	k ʊ ŋ ²¹⁴ +
gòng	k ʊ ŋ ⁵¹ +
gōu	k ɔu ⁵⁵ +
góu	k ɔu ³⁵ +
gǒu	k ɔu ²¹⁴ +
gòu	k ɔu ⁵¹ +
gu	k u ⁰ +
guā	k w a ⁵⁵ +
guá	k w a ³⁵ +
guǎ	k w a ²¹⁴ +
guà	k w a ⁵¹ +
guāi	k w ai ⁵⁵ +
guái	k w ai ³⁵ +
guǎi	k w ai ²¹⁴ +
guài	k w ai ⁵¹ +
guān	k w a n ⁵⁵ +
guán	k w a n ³⁵ +
guǎn	k w a n ²¹⁴ +
guàn	k w a n ⁵¹ +
guāng	k w a ŋ ⁵⁵ +
guáng	k w a ŋ ³⁵ +
guǎng	k w a ŋ ²¹⁴ +
guàng	k w a ŋ ⁵¹ +
guī	k w əi ⁵⁵ +
guí	k w əi ³⁵ +
guǐ	k w əi ²¹⁴ +
guì	k w əi ⁵¹ +
guō	k w ɔ ⁵⁵ +
guó	k w ɔ ³⁵ +
guǒ	k w ɔ ²¹⁴ +
guò	k w ɔ ⁵¹ +
gū	k u ⁵⁵ +
gú	k u ³⁵ +
gǔ	k u ²¹⁴ +
gù	k u ⁵¹ +
gūn	k ʊ n ⁵⁵ +
gún	k ʊ n ³⁵ +
gǔn	k ʊ n ²¹⁴ +
gùn	k ʊ n ⁵¹ +
hā	x a ⁵⁵ +
há	x a ³⁵ +
hǎ	x a ²¹⁴ +
hà	x a ⁵¹ +
hāi	x ai ⁵⁵ +
hái	x ai ³⁵ +
hǎi	x ai ²¹⁴ +
hài	x ai ⁵¹ +
hān	x a n ⁵⁵ +
hán	x a n ³⁵ +
hǎn	x a n ²¹⁴ +
hàn	x a n ⁵¹ +
hāng	x a ŋ ⁵⁵ +
háng	x a ŋ ³⁵ +
hǎng	x a ŋ ²¹⁴ +
hàng	x a ŋ ⁵¹ +
hāo	x au ⁵⁵ +
háo	x au ³⁵ +
hǎo	x au ²¹⁴ +
hào	x au ⁵¹ +
hē	x ə ⁵⁵ +
hé	x ə ³⁵ +
hě	x ə ²¹⁴ +
hè	x ə ⁵¹ +
hēi	x əi ⁵⁵ +
héi	x əi ³⁵ +
hěi	x əi ²¹⁴ +
hèi	x əi ⁵¹ +
hēn	x ə n ⁵⁵ +
hén	x ə n ³⁵ +
hěn	x ə n ²¹⁴ +
hèn	x ə n ⁵¹ +
hēng	x ə ŋ ⁵⁵ +
héng	x ə ŋ ³⁵ +
hěng	x ə ŋ ²¹⁴ +
hèng	x ə ŋ ⁵¹ +
hōng	x ʊ ŋ ⁵⁵ +
hóng	x ʊ ŋ ³⁵ +
hǒng	x ʊ ŋ ²¹⁴ +
hòng	x ʊ ŋ ⁵¹ +
hōu	x ɔu ⁵⁵ +
hóu	x ɔu ³⁵ +
hǒu	x ɔu ²¹⁴ +
hòu	x ɔu ⁵¹ +
hu	x u ⁰ +
huā	x w a ⁵⁵ +
huá	x w a ³⁵ +
huǎ	x w a ²¹⁴ +
huà	x w a ⁵¹ +
huāi	x w ai ⁵⁵ +
huái	x w ai ³⁵ +
huǎi	x w ai ²¹⁴ +
huài	x w ai ⁵¹ +
huān	x w a n ⁵⁵ +
huán	x w a n ³⁵ +
huǎn	x w a n ²¹⁴ +
huàn	x w a n ⁵¹ +
huāng	x w a ŋ ⁵⁵ +
huáng	x w a ŋ ³⁵ +
huǎng	x w a ŋ ²¹⁴ +
huàng	x w a ŋ ⁵¹ +
huī	x w əi ⁵⁵ +
huí	x w əi ³⁵ +
huǐ	x w əi ²¹⁴ +
huì	x w əi ⁵¹ +
huō	x w ɔ ⁵⁵ +
huó	x w ɔ ³⁵ +
huǒ	x w ɔ ²¹⁴ +
huò	x w ɔ ⁵¹ +
hū	x u ⁵⁵ +
hú	x u ³⁵ +
hǔ	x u ²¹⁴ +
hù	x u ⁵¹ +
hūn	x ʊ n ⁵⁵ +
hún	x ʊ n ³⁵ +
hǔn	x ʊ n ²¹⁴ +
hùn	x ʊ n ⁵¹ +
jiā	tɕ j a ⁵⁵ +
jiá	tɕ j a ³⁵ +
jiǎ	tɕ j a ²¹⁴ +
jià	tɕ j a ⁵¹ +
jiān	tɕ j ɛ n ⁵⁵ +
jián	tɕ j ɛ n ³⁵ +
jiǎn	tɕ j ɛ n ²¹⁴ +
jiàn	tɕ j ɛ n ⁵¹ +
jiāng	tɕ j a ŋ ⁵⁵ +
jiáng	tɕ j a ŋ ³⁵ +
jiǎng	tɕ j a ŋ ²¹⁴ +
jiàng	tɕ j a ŋ ⁵¹ +
jiāo	tɕ j au ⁵⁵ +
jiáo	tɕ j au ³⁵ +
jiǎo	tɕ j au ²¹⁴ +
jiào	tɕ j au ⁵¹ +
jie	tɕ j ə ⁰ +
jiē	tɕ j ə ⁵⁵ +
jié	tɕ j ə ³⁵ +
jiě	tɕ j ə ²¹⁴ +
jiè	tɕ j ə ⁵¹ +
jing	tɕ i ŋ ⁰ +
jiū	tɕ j ɔu ⁵⁵ +
jiú	tɕ j ɔu ³⁵ +
jiǔ	tɕ j ɔu ²¹⁴ +
jiù	tɕ j ɔu ⁵¹ +
jī	tɕ i ⁵⁵ +
jí	tɕ i ³⁵ +
jǐ	tɕ i ²¹⁴ +
jì	tɕ i ⁵¹ +
jīn	tɕ i n ⁵⁵ +
jín	tɕ i n ³⁵ +
jǐn	tɕ i n ²¹⁴ +
jìn	tɕ i n ⁵¹ +
jīng	tɕ i ŋ ⁵⁵ +
jíng	tɕ i ŋ ³⁵ +
jǐng	tɕ i ŋ ²¹⁴ +
jìng	tɕ i ŋ ⁵¹ +
jīnɡ	tɕ i ŋ ⁵⁵ +
jínɡ	tɕ i ŋ ³⁵ +
jǐnɡ	tɕ i ŋ ²¹⁴ +
jìnɡ	tɕ i ŋ ⁵¹ +
juē	tɕ ɥ ə ⁵⁵ +
jué	tɕ ɥ ə ³⁵ +
juě	tɕ ɥ ə ²¹⁴ +
juè	tɕ ɥ ə ⁵¹ +
jū	tɕ y ⁵⁵ +
jú	tɕ y ³⁵ +
jǔ	tɕ y ²¹⁴ +
jù	tɕ y ⁵¹ +
jūn	tɕ y n ⁵⁵ +
jún	tɕ y n ³⁵ +
jǔn	tɕ y n ²¹⁴ +
jùn	tɕ y n ⁵¹ +
kāi	kʰ ai ⁵⁵ +
kái	kʰ ai ³⁵ +
kǎi	kʰ ai ²¹⁴ +
kài	kʰ ai ⁵¹ +
kān	kʰ a n ⁵⁵ +
kán	kʰ a n ³⁵ +
kǎn	kʰ a n ²¹⁴ +
kàn	kʰ a n ⁵¹ +
kāng	kʰ a ŋ ⁵⁵ +
káng	kʰ a ŋ ³⁵ +
kǎng	kʰ a ŋ ²¹⁴ +
kàng	kʰ a ŋ ⁵¹ +
kāo	kʰ au ⁵⁵ +
káo	kʰ au ³⁵ +
kǎo	kʰ au ²¹⁴ +
kào	kʰ au ⁵¹ +
kē	kʰ ə ⁵⁵ +
ké	kʰ ə ³⁵ +
kě	kʰ ə ²¹⁴ +
kè	kʰ ə ⁵¹ +
kōng	kʰ ʊ ŋ ⁵⁵ +
kóng	kʰ ʊ ŋ ³⁵ +
kǒng	kʰ ʊ ŋ ²¹⁴ +
kòng	kʰ ʊ ŋ ⁵¹ +
kōu	kʰ ɔu ⁵⁵ +
kóu	kʰ ɔu ³⁵ +
kǒu	kʰ ɔu ²¹⁴ +
kòu	kʰ ɔu ⁵¹ +
kuā	kʰ w a ⁵⁵ +
kuá	kʰ w a ³⁵ +
kuǎ	kʰ w a ²¹⁴ +
kuà	kʰ w a ⁵¹ +
kuāi	kʰ w ai ⁵⁵ +
kuái	kʰ w ai ³⁵ +
kuǎi	kʰ w ai ²¹⁴ +
kuài	kʰ w ai ⁵¹ +
kuān	kʰ w a n ⁵⁵ +
kuán	kʰ w a n ³⁵ +
kuǎn	kʰ w a n ²¹⁴ +
kuàn	kʰ w a n ⁵¹ +
kuāng	kʰ w a ŋ ⁵⁵ +
kuáng	kʰ w a ŋ ³⁵ +
kuǎng	kʰ w a ŋ ²¹⁴ +
kuàng	kʰ w a ŋ ⁵¹ +
kuī	kʰ w əi ⁵⁵ +
kuí	kʰ w əi ³⁵ +
kuǐ	kʰ w əi ²¹⁴ +
kuì	kʰ w əi ⁵¹ +
kū	kʰ u ⁵⁵ +
kú	kʰ u ³⁵ +
kǔ	kʰ u ²¹⁴ +
kù	kʰ u ⁵¹ +
kūn	kʰ ʊ n ⁵⁵ +
kún	kʰ ʊ n ³⁵ +
kǔn	kʰ ʊ n ²¹⁴ +
kùn	kʰ ʊ n ⁵¹ +
lā	l a ⁵⁵ +
lá	l a ³⁵ +
lǎ	l a ²¹⁴ +
là	l a ⁵¹ +
lāi	l ai ⁵⁵ +
lái	l ai ³⁵ +
lǎi	l ai ²¹⁴ +
lài	l ai ⁵¹ +
lān	l a n ⁵⁵ +
lán	l a n ³⁵ +
lǎn	l a n ²¹⁴ +
làn	l a n ⁵¹ +
lāng	l a ŋ ⁵⁵ +
láng	l a ŋ ³⁵ +
lǎng	l a ŋ ²¹⁴ +
làng	l a ŋ ⁵¹ +
lāo	l au ⁵⁵ +
láo	l au ³⁵ +
lǎo	l au ²¹⁴ +
lào	l au ⁵¹ +
lē	l ə ⁵⁵ +
lé	l ə ³⁵ +
lě	l ə ²¹⁴ +
lè	l ə ⁵¹ +
lēi	l əi ⁵⁵ +
léi	l əi ³⁵ +
lěi	l əi ²¹⁴ +
lèi	l əi ⁵¹ +
lēng	l ə ŋ ⁵⁵ +
léng	l ə ŋ ³⁵ +
lěng	l ə ŋ ²¹⁴ +
lèng	l ə ŋ ⁵¹ +
li	l i ⁰ +
liān	l j ɛ n ⁵⁵ +
lián	l j ɛ n ³⁵ +
liǎn	l j ɛ n ²¹⁴ +
liàn	l j ɛ n ⁵¹ +
liāng	l j a ŋ ⁵⁵ +
liáng	l j a ŋ ³⁵ +
liǎng	l j a ŋ ²¹⁴ +
liàng	l j a ŋ ⁵¹ +
liāo	l j au ⁵⁵ +
liáo	l j au ³⁵ +
liǎo	l j au ²¹⁴ +
liào	l j au ⁵¹ +
liē	l j ə ⁵⁵ +
lié	l j ə ³⁵ +
liě	l j ə ²¹⁴ +
liè	l j ə ⁵¹ +
liū	l j ɔu ⁵⁵ +
liú	l j ɔu ³⁵ +
liǔ	l j ɔu ²¹⁴ +
liù	l j ɔu ⁵¹ +
lī	l i ⁵⁵ +
lí	l i ³⁵ +
lǐ	l i ²¹⁴ +
lì	l i ⁵¹ +
līn	l i n ⁵⁵ +
lín	l i n ³⁵ +
lǐn	l i n ²¹⁴ +
lìn	l i n ⁵¹ +
līng	l i ŋ ⁵⁵ +
líng	l i ŋ ³⁵ +
lǐng	l i ŋ ²¹⁴ +
lìng	l i ŋ ⁵¹ +
lōng	l ʊ ŋ ⁵⁵ +
lóng	l ʊ ŋ ³⁵ +
lǒng	l ʊ ŋ ²¹⁴ +
lòng	l ʊ ŋ ⁵¹ +
lōu	l ɔu ⁵⁵ +
lóu	l ɔu ³⁵ +
lǒu	l ɔu ²¹⁴ +
lòu	l ɔu ⁵¹ +
lu	l u ⁰ +
luān	l w a n ⁵⁵ +
luán	l w a n ³⁵ +
luǎn	l w a n ²¹⁴ +
luàn	l w a n ⁵¹ +
luō	l w ɔ ⁵⁵ +
luó	l w ɔ ³⁵ +
luǒ	l w ɔ ²¹⁴ +
luò	l w ɔ ⁵¹ +
lū	l u ⁵⁵ +
lú	l u ³⁵ +
lǔ	l u ²¹⁴ +
lù	l u ⁵¹ +
lūn	l ʊ n ⁵⁵ +
lún	l ʊ n ³⁵ +
lǔn	l ʊ n ²¹⁴ +
lùn	l ʊ n ⁵¹ +
mao	m au ⁰ +
mā	m a ⁵⁵ +
má	m a ³⁵ +
mǎ	m a ²¹⁴ +
mà	m a ⁵¹ +
māi	m ai ⁵⁵ +
mái	m ai ³⁵ +
mǎi	m ai ²¹⁴ +
mài	m ai ⁵¹ +
mān	m a n ⁵⁵ +
mán	m a n ³⁵ +
mǎn	m a n ²¹⁴ +
màn	m a n ⁵¹ +
māng	m a ŋ ⁵⁵ +
máng	m a ŋ ³⁵ +
mǎng	m a ŋ ²¹⁴ +
màng	m a ŋ ⁵¹ +
māo	m au ⁵⁵ +
máo	m au ³⁵ +
mǎo	m au ²¹⁴ +
mào	m au ⁵¹ +
mei	m əi ⁰ +
men	m ə n ⁰ +
mēi	m əi ⁵⁵ +
méi	m əi ³⁵ +
měi	m əi ²¹⁴ +
mèi	m əi ⁵¹ +
mēn	m ə n ⁵⁵ +
mén	m ə n ³⁵ +
měn	m ə n ²¹⁴ +
mèn	m ə n ⁵¹ +
mēng	m ə ŋ ⁵⁵ +
méng	m ə ŋ ³⁵ +
měng	m ə ŋ ²¹⁴ +
mèng	m ə ŋ ⁵¹ +
miān	m j ɛ n ⁵⁵ +
mián	m j ɛ n ³⁵ +
miǎn	m j ɛ n ²¹⁴ +
miàn	m j ɛ n ⁵¹ +
miāo	m j au ⁵⁵ +
miáo	m j au ³⁵ +
miǎo	m j au ²¹⁴ +
miào	m j au ⁵¹ +
miē	m j ə ⁵⁵ +
mié	m j ə ³⁵ +
miě	m j ə ²¹⁴ +
miè	m j ə ⁵¹ +
ming	m i ŋ ⁰ +
mī	m i ⁵⁵ +
mí	m i ³⁵ +
mǐ	m i ²¹⁴ +
mì	m i ⁵¹ +
mīn	m i n ⁵⁵ +
mín	m i n ³⁵ +
mǐn	m i n ²¹⁴ +
mìn	m i n ⁵¹ +
mīng	m i ŋ ⁵⁵ +
míng	m i ŋ ³⁵ +
mǐng	m i ŋ ²¹⁴ +
mìng	m i ŋ ⁵¹ +
mō	m w ɔ ⁵⁵ +
mó	m w ɔ ³⁵ +
mǒ	m w ɔ ²¹⁴ +
mò	m w ɔ ⁵¹ +
mōu	m ɔu ⁵⁵ +
móu	m ɔu ³⁵ +
mǒu	m ɔu ²¹⁴ +
mòu	m ɔu ⁵¹ +
mū	m u ⁵⁵ +
mú	m u ³⁵ +
mǔ	m u ²¹⁴ +
mù	m u ⁵¹ +
nā	n a ⁵⁵ +
ná	n a ³⁵ +
nǎ	n a ²¹⁴ +
nà	n a ⁵¹ +
nāi	n ai ⁵⁵ +
nái	n ai ³⁵ +
nǎi	n ai ²¹⁴ +
nài	n ai ⁵¹ +
nān	n a n ⁵⁵ +
nán	n a n ³⁵ +
nǎn	n a n ²¹⁴ +
nàn	n a n ⁵¹ +
nāo	n au ⁵⁵ +
náo	n au ³⁵ +
nǎo	n au ²¹⁴ +
nào	n au ⁵¹ +
niān	n j ɛ n ⁵⁵ +
nián	n j ɛ n ³⁵ +
niǎn	n j ɛ n ²¹⁴ +
niàn	n j ɛ n ⁵¹ +
niāo	n j au ⁵⁵ +
niáo	n j au ³⁵ +
niǎo	n j au ²¹⁴ +
niào	n j au ⁵¹ +
niē	n j ə ⁵⁵ +
nié	n j ə ³⁵ +
niě	n j ə ²¹⁴ +
niè	n j ə ⁵¹ +
niū	n j ɔu ⁵⁵ +
niú	n j ɔu ³⁵ +
niǔ	n j ɔu ²¹⁴ +
niù	n j ɔu ⁵¹ +
nī	n i ⁵⁵ +
ní	n i ³⁵ +
nǐ	n i ²¹⁴ +
nì	n i ⁵¹ +
nīng	n i ŋ ⁵⁵ +
níng	n i ŋ ³⁵ +
nǐng	n i ŋ ²¹⁴ +
nìng	n i ŋ ⁵¹ +
nong	n ʊ ŋ ⁰ +
nōng	n ʊ ŋ ⁵⁵ +
nóng	n ʊ ŋ ³⁵ +
nǒng	n ʊ ŋ ²¹⁴ +
nòng	n ʊ ŋ ⁵¹ +
nuān	n w a n ⁵⁵ +
nuán	n w a n ³⁵ +
nuǎn	n w a n ²¹⁴ +
nuàn	n w a n ⁵¹ +
nuō	n w ɔ ⁵⁵ +
nuó	n w ɔ ³⁵ +
nuǒ	n w ɔ ²¹⁴ +
nuò	n w ɔ ⁵¹ +
nū	n u ⁵⁵ +
nú	n u ³⁵ +
nǔ	n u ²¹⁴ +
nù	n u ⁵¹ +
ōu	ɔu ⁵⁵ +
óu	ɔu ³⁵ +
ǒu	ɔu ²¹⁴ +
òu	ɔu ⁵¹ +
pā	pʰ a ⁵⁵ +
pá	pʰ a ³⁵ +
pǎ	pʰ a ²¹⁴ +
pà	pʰ a ⁵¹ +
pāi	pʰ ai ⁵⁵ +
pái	pʰ ai ³⁵ +
pǎi	pʰ ai ²¹⁴ +
pài	pʰ ai ⁵¹ +
pān	pʰ a n ⁵⁵ +
pán	pʰ a n ³⁵ +
pǎn	pʰ a n ²¹⁴ +
pàn	pʰ a n ⁵¹ +
pāng	pʰ a ŋ ⁵⁵ +
páng	pʰ a ŋ ³⁵ +
pǎng	pʰ a ŋ ²¹⁴ +
pàng	pʰ a ŋ ⁵¹ +
pāo	pʰ au ⁵⁵ +
páo	pʰ au ³⁵ +
pǎo	pʰ au ²¹⁴ +
pào	pʰ au ⁵¹ +
peng	pʰ ə ŋ ⁰ +
pēi	pʰ əi ⁵⁵ +
péi	pʰ əi ³⁵ +
pěi	pʰ əi ²¹⁴ +
pèi	pʰ əi ⁵¹ +
pēn	pʰ ə n ⁵⁵ +
pén	pʰ ə n ³⁵ +
pěn	pʰ ə n ²¹⁴ +
pèn	pʰ ə n ⁵¹ +
pēng	pʰ ə ŋ ⁵⁵ +
péng	pʰ ə ŋ ³⁵ +
pěng	pʰ ə ŋ ²¹⁴ +
pèng	pʰ ə ŋ ⁵¹ +
piān	pʰ j ɛ n ⁵⁵ +
pián	pʰ j ɛ n ³⁵ +
piǎn	pʰ j ɛ n ²¹⁴ +
piàn	pʰ j ɛ n ⁵¹ +
pī	pʰ i ⁵⁵ +
pí	pʰ i ³⁵ +
pǐ	pʰ i ²¹⁴ +
pì	pʰ i ⁵¹ +
pīn	pʰ i n ⁵⁵ +
pín	pʰ i n ³⁵ +
pǐn	pʰ i n ²¹⁴ +
pìn	pʰ i n ⁵¹ +
pīng	pʰ i ŋ ⁵⁵ +
píng	pʰ i ŋ ³⁵ +
pǐng	pʰ i ŋ ²¹⁴ +
pìng	pʰ i ŋ ⁵¹ +
po	pʰ w ɔ ⁰ +
pō	pʰ w ɔ ⁵⁵ +
pó	pʰ w ɔ ³⁵ +
pǒ	pʰ w ɔ ²¹⁴ +
pò	pʰ w ɔ ⁵¹ +
pū	pʰ u ⁵⁵ +
pú	pʰ u ³⁵ +
pǔ	pʰ u ²¹⁴ +
pù	pʰ u ⁵¹ +
qi	tɕʰ ⁰ +
qian	tɕʰ j ɛ n ⁰ +
qiā	tɕʰ j a ⁵⁵ +
qiá	tɕʰ j a ³⁵ +
qiǎ	tɕʰ j a ²¹⁴ +
qià	tɕʰ j a ⁵¹ +
qiān	tɕʰ j ɛ n ⁵⁵ +
qián	tɕʰ j ɛ n ³⁵ +
qiǎn	tɕʰ j ɛ n ²¹⁴ +
qiàn	tɕʰ j ɛ n ⁵¹ +
qiāng	tɕʰ j a ŋ ⁵⁵ +
qiáng	tɕʰ j a ŋ ³⁵ +
qiǎng	tɕʰ j a ŋ ²¹⁴ +
qiàng	tɕʰ j a ŋ ⁵¹ +
qiāo	tɕʰ j au ⁵⁵ +
qiáo	tɕʰ j au ³⁵ +
qiǎo	tɕʰ j au ²¹⁴ +
qiào	tɕʰ j au ⁵¹ +
qiē	tɕʰ j ə ⁵⁵ +
qié	tɕʰ j ə ³⁵ +
qiě	tɕʰ j ə ²¹⁴ +
qiè	tɕʰ j ə ⁵¹ +
qin	tɕʰ i n ⁰ +
qing	tɕʰ i ŋ ⁰ +
qiōng	tɕʰ j ʊ ŋ ⁵⁵ +
qióng	tɕʰ j ʊ ŋ ³⁵ +
qiǒng	tɕʰ j ʊ ŋ ²¹⁴ +
qiòng	tɕʰ j ʊ ŋ ⁵¹ +
qiū	tɕʰ j ɔu ⁵⁵ +
qiú	tɕʰ j ɔu ³⁵ +
qiǔ	tɕʰ j ɔu ²¹⁴ +
qiù	tɕʰ j ɔu ⁵¹ +
qī	tɕʰ i ⁵⁵ +
qí	tɕʰ i ³⁵ +
qǐ	tɕʰ i ²¹⁴ +
qì	tɕʰ i ⁵¹ +
qīn	tɕʰ i n ⁵⁵ +
qín	tɕʰ i n ³⁵ +
qǐn	tɕʰ i n ²¹⁴ +
qìn	tɕʰ i n ⁵¹ +
qīng	tɕʰ i ŋ ⁵⁵ +
qíng	tɕʰ i ŋ ³⁵ +
qǐng	tɕʰ i ŋ ²¹⁴ +
qìng	tɕʰ i ŋ ⁵¹ +
quān	tɕʰ ɥ ɛ n ⁵⁵ +
quán	tɕʰ ɥ ɛ n ³⁵ +
quǎn	tɕʰ ɥ ɛ n ²¹⁴ +
quàn	tɕʰ ɥ ɛ n ⁵¹ +
quē	tɕʰ ɥ ə ⁵⁵ +
qué	tɕʰ ɥ ə ³⁵ +
quě	tɕʰ ɥ ə ²¹⁴ +
què	tɕʰ ɥ ə ⁵¹ +
qū	tɕʰ y ⁵⁵ +
qú	tɕʰ y ³⁵ +
qǔ	tɕʰ y ²¹⁴ +
qù	tɕʰ y ⁵¹ +
qūn	tɕʰ y n ⁵⁵ +
qún	tɕʰ y n ³⁵ +
qǔn	tɕʰ y n ²¹⁴ +
qùn	tɕʰ y n ⁵¹ +
rān	ʐ a n ⁵⁵ +
rán	ʐ a n ³⁵ +
rǎn	ʐ a n ²¹⁴ +
ràn	ʐ a n ⁵¹ +
rāo	ʐ au ⁵⁵ +
ráo	ʐ au ³⁵ +
rǎo	ʐ au ²¹⁴ +
rào	ʐ au ⁵¹ +
rē	ʐ ə ⁵⁵ +
ré	ʐ ə ³⁵ +
rě	ʐ ə ²¹⁴ +
rè	ʐ ə ⁵¹ +
rēn	ʐ ə n ⁵⁵ +
rén	ʐ ə n ³⁵ +
rěn	ʐ ə n ²¹⁴ +
rèn	ʐ ə n ⁵¹ +
rēng	ʐ ə ŋ ⁵⁵ +
réng	ʐ ə ŋ ³⁵ +
rěng	ʐ ə ŋ ²¹⁴ +
rèng	ʐ ə ŋ ⁵¹ +
rī	ʐ ʅ ⁵⁵ +
rí	ʐ ʅ ³⁵ +
rǐ	ʐ ʅ ²¹⁴ +
rì	ʐ ʅ ⁵¹ +
rōng	ʐ ʊ ŋ ⁵⁵ +
róng	ʐ ʊ ŋ ³⁵ +
rǒng	ʐ ʊ ŋ ²¹⁴ +
ròng	ʐ ʊ ŋ ⁵¹ +
rōu	ʐ ɔu ⁵⁵ +
róu	ʐ ɔu ³⁵ +
rǒu	ʐ ɔu ²¹⁴ +
ròu	ʐ ɔu ⁵¹ +
ruān	ʐ w a n ⁵⁵ +
ruán	ʐ w a n ³⁵ +
ruǎn	ʐ w a n ²¹⁴ +
ruàn	ʐ w a n ⁵¹ +
ruō	ʐ w ɔ ⁵⁵ +
ruó	ʐ w ɔ ³⁵ +
ruǒ	ʐ w ɔ ²¹⁴ +
ruò	ʐ w ɔ ⁵¹ +
rū	ʐ u ⁵⁵ +
rú	ʐ u ³⁵ +
rǔ	ʐ u ²¹⁴ +
rù	ʐ u ⁵¹ +
sāi	s ai ⁵⁵ +
sái	s ai ³⁵ +
sǎi	s ai ²¹⁴ +
sài	s ai ⁵¹ +
sān	s a n ⁵⁵ +
sán	s a n ³⁵ +
sǎn	s a n ²¹⁴ +
sàn	s a n ⁵¹ +
sāo	s au ⁵⁵ +
sáo	s au ³⁵ +
sǎo	s au ²¹⁴ +
sào	s au ⁵¹ +
sē	s ə ⁵⁵ +
sé	s ə ³⁵ +
sě	s ə ²¹⁴ +
sè	s ə ⁵¹ +
sēn	s ə n ⁵⁵ +
sén	s ə n ³⁵ +
sěn	s ə n ²¹⁴ +
sèn	s ə n ⁵¹ +
shang	ʂ a ŋ ⁰ +
shā	ʂ a ⁵⁵ +
shá	ʂ a ³⁵ +
shǎ	ʂ a ²¹⁴ +
shà	ʂ a ⁵¹ +
shāi	ʂ ai ⁵⁵ +
shái	ʂ ai ³⁵ +
shǎi	ʂ ai ²¹⁴ +
shài	ʂ ai ⁵¹ +
shān	ʂ a n ⁵⁵ +
shán	ʂ a n ³⁵ +
shǎn	ʂ a n ²¹⁴ +
shàn	ʂ a n ⁵¹ +
shāng	ʂ a ŋ ⁵⁵ +
sháng	ʂ a ŋ ³⁵ +
shǎng	ʂ a ŋ ²¹⁴ +
shàng	ʂ a ŋ ⁵¹ +
shāo	ʂ au ⁵⁵ +
sháo	ʂ au ³⁵ +
shǎo	ʂ au ²¹⁴ +
shào	ʂ au ⁵¹ +
sheng	ʂ ə ŋ ⁰ +
shē	ʂ ə ⁵⁵ +
shé	ʂ ə ³⁵ +
shě	ʂ ə ²¹⁴ +
shè	ʂ ə ⁵¹ +
shēn	ʂ ə n ⁵⁵ +
shén	ʂ ə n ³⁵ +
shěn	ʂ ə n ²¹⁴ +
shèn	ʂ ə n ⁵¹ +
shēng	ʂ ə ŋ ⁵⁵ +
shéng	ʂ ə ŋ ³⁵ +
shěng	ʂ ə ŋ ²¹⁴ +
shèng	ʂ ə ŋ ⁵¹ +
shēnɡ	ʂ ə ŋ ⁵⁵ +
shénɡ	ʂ ə ŋ ³⁵ +
shěnɡ	ʂ ə ŋ ²¹⁴ +
shènɡ	ʂ ə ŋ ⁵¹ +
shi	ʂ ʅ ⁰ +
shī	ʂ ʅ ⁵⁵ +
shí	ʂ ʅ ³⁵ +
shǐ	ʂ ʅ ²¹⁴ +
shì	ʂ ʅ ⁵¹ +
shōu	ʂ ɔu ⁵⁵ +
shóu	ʂ ɔu ³⁵ +
shǒu	ʂ ɔu ²¹⁴ +
shòu	ʂ ɔu ⁵¹ +
shuā	ʂ w a ⁵⁵ +
shuá	ʂ w a ³⁵ +
shuǎ	ʂ w a ²¹⁴ +
shuà	ʂ w a ⁵¹ +
shuān	ʂ w a n ⁵⁵ +
shuán	ʂ w a n ³⁵ +
shuǎn	ʂ w a n ²¹⁴ +
shuàn	ʂ w a n ⁵¹ +
shuāng	ʂ w a ŋ ⁵⁵ +
shuáng	ʂ w a ŋ ³⁵ +
shuǎng	ʂ w a ŋ ²¹⁴ +
shuàng	ʂ w a ŋ ⁵¹ +
shuī	ʂ w əi ⁵⁵ +
shuí	ʂ w əi ³⁵ +
shuǐ	ʂ w əi ²¹⁴ +
shuì	ʂ w əi ⁵¹ +
shuō	ʂ w ɔ ⁵⁵ +
shuó	ʂ w ɔ ³⁵ +
shuǒ	ʂ w ɔ ²¹⁴ +
shuò	ʂ w ɔ ⁵¹ +
shū	ʂ u ⁵⁵ +
shú	ʂ u ³⁵ +
shǔ	ʂ u ²¹⁴ +
shù	ʂ u ⁵¹ +
sī	s ɿ ⁵⁵ +
sí	s ɿ ³⁵ +
sǐ	s ɿ ²¹⁴ +
sì	s ɿ ⁵¹ +
sōng	s ʊ ŋ ⁵⁵ +
sóng	s ʊ ŋ ³⁵ +
sǒng	s ʊ ŋ ²¹⁴ +
sòng	s ʊ ŋ ⁵¹ +
suān	s w a n ⁵⁵ +
suán	s w a n ³⁵ +
suǎn	s w a n ²¹⁴ +
suàn	s w a n ⁵¹ +
suī	s w əi ⁵⁵ +
suí	s w əi ³⁵ +
suǐ	s w əi ²¹⁴ +
suì	s w əi ⁵¹ +
suō	s w ɔ ⁵⁵ +
suó	s w ɔ ³⁵ +
suǒ	s w ɔ ²¹⁴ +
suò	s w ɔ ⁵¹ +
sū	s u ⁵⁵ +
sú	s u ³⁵ +
sǔ	s u ²¹⁴ +
sù	s u ⁵¹ +
sūn	s ʊ n ⁵⁵ +
sún	s ʊ n ³⁵ +
sǔn	s ʊ n ²¹⁴ +
sùn	s ʊ n ⁵¹ +
tao	tʰ au ⁰ +
tā	tʰ a ⁵⁵ +
tá	tʰ a ³⁵ +
tǎ	tʰ a ²¹⁴ +
tà	tʰ a ⁵¹ +
tāi	tʰ ai ⁵⁵ +
tái	tʰ ai ³⁵ +
tǎi	tʰ ai ²¹⁴ +
tài	tʰ ai ⁵¹ +
tān	tʰ a n ⁵⁵ +
tán	tʰ a n ³⁵ +
tǎn	tʰ a n ²¹⁴ +
tàn	tʰ a n ⁵¹ +
tāng	tʰ a ŋ ⁵⁵ +
táng	tʰ a ŋ ³⁵ +
tǎng	tʰ a ŋ ²¹⁴ +
tàng	tʰ a ŋ ⁵¹ +
tāo	tʰ au ⁵⁵ +
táo	tʰ au ³⁵ +
tǎo	tʰ au ²¹⁴ +
tào	tʰ au ⁵¹ +
tēng	tʰ ə ŋ ⁵⁵ +
téng	tʰ ə ŋ ³⁵ +
těng	tʰ ə ŋ ²¹⁴ +
tèng	tʰ ə ŋ ⁵¹ +
tiān	tʰ j ɛ n ⁵⁵ +
tián	tʰ j ɛ n ³⁵ +
tiǎn	tʰ j ɛ n ²¹⁴ +
tiàn	tʰ j ɛ n ⁵¹ +
tiāo	tʰ j au ⁵⁵ +
tiáo	tʰ j au ³⁵ +
tiǎo	tʰ j au ²¹⁴ +
tiào	tʰ j au ⁵¹ +
tiē	tʰ j ə ⁵⁵ +
tié	tʰ j ə ³⁵ +
tiě	tʰ j ə ²¹⁴ +
tiè	tʰ j ə ⁵¹ +
tī	tʰ i ⁵⁵ +
tí	tʰ i ³⁵ +
tǐ	tʰ i ²¹⁴ +
tì	tʰ i ⁵¹ +
tīng	tʰ i ŋ ⁵⁵ +
tíng	tʰ i ŋ ³⁵ +
tǐng	tʰ i ŋ ²¹⁴ +
tìng	tʰ i ŋ ⁵¹ +
tou	tʰ ɔu ⁰ +
tōng	tʰ ʊ ŋ ⁵⁵ +
tóng	tʰ ʊ ŋ ³⁵ +
tǒng	tʰ ʊ ŋ ²¹⁴ +
tòng	tʰ ʊ ŋ ⁵¹ +
tōu	tʰ ɔu ⁵⁵ +
tóu	tʰ ɔu ³⁵ +
tǒu	tʰ ɔu ²¹⁴ +
tòu	tʰ ɔu ⁵¹ +
tuān	tʰ w a n ⁵⁵ +
tuán	tʰ w a n ³⁵ +
tuǎn	tʰ w a n ²¹⁴ +
tuàn	tʰ w a n ⁵¹ +
tuī	tʰ w əi ⁵⁵ +
tuí	tʰ w əi ³⁵ +
tuǐ	tʰ w əi ²¹⁴ +
tuì	tʰ w əi ⁵¹ +
tuo	tʰ w ɔ ⁰ +
tuō	tʰ w ɔ ⁵⁵ +
tuó	tʰ w ɔ ³⁵ +
tuǒ	tʰ w ɔ ²¹⁴ +
tuò	tʰ w ɔ ⁵¹ +
tū	tʰ u ⁵⁵ +
tú	tʰ u ³⁵ +
tǔ	tʰ u ²¹⁴ +
tù	tʰ u ⁵¹ +
tūn	tʰ ʊ n ⁵⁵ +
tún	tʰ ʊ n ³⁵ +
tǔn	tʰ ʊ n ²¹⁴ +
tùn	tʰ ʊ n ⁵¹ +
wā	w a ⁵⁵ +
wá	w a ³⁵ +
wǎ	w a ²¹⁴ +
wà	w a ⁵¹ +
wāi	w ai ⁵⁵ +
wái	w ai ³⁵ +
wǎi	w ai ²¹⁴ +
wài	w ai ⁵¹ +
wān	w a n ⁵⁵ +
wán	w a n ³⁵ +
wǎn	w a n ²¹⁴ +
wàn	w a n ⁵¹ +
wāng	w a ŋ ⁵⁵ +
wáng	w a ŋ ³⁵ +
wǎng	w a ŋ ²¹⁴ +
wàng	w a ŋ ⁵¹ +
wēi	w əi ⁵⁵ +
wéi	w əi ³⁵ +
wěi	w əi ²¹⁴ +
wèi	w əi ⁵¹ +
wēn	w ə n ⁵⁵ +
wén	w ə n ³⁵ +
wěn	w ə n ²¹⁴ +
wèn	w ə n ⁵¹ +
wō	w ɔ ⁵⁵ +
wó	w ɔ ³⁵ +
wǒ	w ɔ ²¹⁴ +
wò	w ɔ ⁵¹ +
wū	w u ⁵⁵ +
wú	w u ³⁵ +
wǔ	w u ²¹⁴ +
wù	w u ⁵¹ +
xi	ɕ i ⁰ +
xiā	ɕ j a ⁵⁵ +
xiá	ɕ j a ³⁵ +
xiǎ	ɕ j a ²¹⁴ +
xià	ɕ j a ⁵¹ +
xiān	ɕ j ɛ n ⁵⁵ +
xián	ɕ j ɛ n ³⁵ +
xiǎn	ɕ j ɛ n ²¹⁴ +
xiàn	ɕ j ɛ n ⁵¹ +
xiāng	ɕ j a ŋ ⁵⁵ +
xiáng	ɕ j a ŋ ³⁵ +
xiǎng	ɕ j a ŋ ²¹⁴ +
xiàng	ɕ j a ŋ ⁵¹ +
xiāo	ɕ j au ⁵⁵ +
xiáo	ɕ j au ³⁵ +
xiǎo	ɕ j au ²¹⁴ +
xiào	ɕ j au ⁵¹ +
xiē	ɕ j ə ⁵⁵ +
xié	ɕ j ə ³⁵ +
xiě	ɕ j ə ²¹⁴ +
xiè	ɕ j ə ⁵¹ +
xiōng	ɕ j ʊ ŋ ⁵⁵ +
xióng	ɕ j ʊ ŋ ³⁵ +
xiǒng	ɕ j ʊ ŋ ²¹⁴ +
xiòng	ɕ j ʊ ŋ ⁵¹ +
xiū	ɕ j ɔu ⁵⁵ +
xiú	ɕ j ɔu ³⁵ +
xiǔ	ɕ j ɔu ²¹⁴ +
xiù	ɕ j ɔu ⁵¹ +
xī	ɕ i ⁵⁵ +
xí	ɕ i ³⁵ +
xǐ	ɕ i ²¹⁴ +
xì	ɕ i ⁵¹ +
xīn	ɕ i n ⁵⁵ +
xín	ɕ i n ³⁵ +
xǐn	ɕ i n ²¹⁴ +
xìn	ɕ i n ⁵¹ +
xīng	ɕ i ŋ ⁵⁵ +
xíng	ɕ i ŋ ³⁵ +
xǐng	ɕ i ŋ ²¹⁴ +
xìng	ɕ i ŋ ⁵¹ +
xu	ɕ y ⁰ +
xuān	ɕ ɥ ɛ n ⁵⁵ +
xuán	ɕ ɥ ɛ n ³⁵ +
xuǎn	ɕ ɥ ɛ n ²¹⁴ +
xuàn	ɕ ɥ ɛ n ⁵¹ +
xuē	ɕ ɥ ə ⁵⁵ +
xué	ɕ ɥ ə ³⁵ +
xuě	ɕ ɥ ə ²¹⁴ +
xuè	ɕ ɥ ə ⁵¹ +
xū	ɕ y ⁵⁵ +
xú	ɕ y ³⁵ +
xǔ	ɕ y ²¹⁴ +
xù	ɕ y ⁵¹ +
xūn	ɕ y n ⁵⁵ +
xún	ɕ y n ³⁵ +
xǔn	ɕ y n ²¹⁴ +
xùn	ɕ y n ⁵¹ +
yā	j a ⁵⁵ +
yá	j a ³⁵ +
yǎ	j a ²¹⁴ +
yà	j a ⁵¹ +
yān	j a n ⁵⁵ +
yán	j a n ³⁵ +
yǎn	j a n ²¹⁴ +
yàn	j a n ⁵¹ +
yāng	j a ŋ ⁵⁵ +
yáng	j a ŋ ³⁵ +
yǎng	j a ŋ ²¹⁴ +
yàng	j a ŋ ⁵¹ +
yāo	j au ⁵⁵ +
yáo	j au ³⁵ +
yǎo	j au ²¹⁴ +
yào	j au ⁵¹ +
yē	j ə ⁵⁵ +
yé	j ə ³⁵ +
yě	j ə ²¹⁴ +
yè	j ə ⁵¹ +
yi	j i ⁰ +
ying	j i ŋ ⁰ +
yī	j i ⁵⁵ +
yí	j i ³⁵ +
yǐ	j i ²¹⁴ +
yì	j i ⁵¹ +
yīn	j i n ⁵⁵ +
yín	j i n ³⁵ +
yǐn	j i n ²¹⁴ +
yìn	j i n ⁵¹ +
yīng	j i ŋ ⁵⁵ +
yíng	j i ŋ ³⁵ +
yǐng	j i ŋ ²¹⁴ +
yìng	j i ŋ ⁵¹ +
you	j ɔu ⁰ +
yōng	j ʊ ŋ ⁵⁵ +
yóng	j ʊ ŋ ³⁵ +
yǒng	j ʊ ŋ ²¹⁴ +
yòng	j ʊ ŋ ⁵¹ +
yōu	j ɔu ⁵⁵ +
yóu	j ɔu ³⁵ +
yǒu	j ɔu ²¹⁴ +
yòu	j ɔu ⁵¹ +
yuān	ɥ ɛ n ⁵⁵ +
yuán	ɥ ɛ n ³⁵ +
yuǎn	ɥ ɛ n ²¹⁴ +
yuàn	ɥ ɛ n ⁵¹ +
yuē	ɥ ə ⁵⁵ +
yué	ɥ ə ³⁵ +
yuě	ɥ ə ²¹⁴ +
yuè	ɥ ə ⁵¹ +
yū	ɥ y ⁵⁵ +
yú	ɥ y ³⁵ +
yǔ	ɥ y ²¹⁴ +
yù	ɥ y ⁵¹ +
yūn	ɥ y n ⁵⁵ +
yún	ɥ y n ³⁵ +
yǔn	ɥ y n ²¹⁴ +
yùn	ɥ y n ⁵¹ +
zao	ts au ⁰ +
zāi	ts ai ⁵⁵ +
zái	ts ai ³⁵ +
zǎi	ts ai ²¹⁴ +
zài	ts ai ⁵¹ +
zān	ts a n ⁵⁵ +
zán	ts a n ³⁵ +
zǎn	ts a n ²¹⁴ +
zàn	ts a n ⁵¹ +
zāng	ts a ŋ ⁵⁵ +
záng	ts a ŋ ³⁵ +
zǎng	ts a ŋ ²¹⁴ +
zàng	ts a ŋ ⁵¹ +
zāo	ts au ⁵⁵ +
záo	ts au ³⁵ +
zǎo	ts au ²¹⁴ +
zào	ts au ⁵¹ +
zē	ts ə ⁵⁵ +
zé	ts ə ³⁵ +
zě	ts ə ²¹⁴ +
zè	ts ə ⁵¹ +
zhā	ʈʂ a ⁵⁵ +
zhá	ʈʂ a ³⁵ +
zhǎ	ʈʂ a ²¹⁴ +
zhà	ʈʂ a ⁵¹ +
zhāi	ʈʂ ai ⁵⁵ +
zhái	ʈʂ ai ³⁵ +
zhǎi	ʈʂ ai ²¹⁴ +
zhài	ʈʂ ai ⁵¹ +
zhān	ʈʂ a n ⁵⁵ +
zhán	ʈʂ a n ³⁵ +
zhǎn	ʈʂ a n ²¹⁴ +
zhàn	ʈʂ a n ⁵¹ +
zhāng	ʈʂ a ŋ ⁵⁵ +
zháng	ʈʂ a ŋ ³⁵ +
zhǎng	ʈʂ a ŋ ²¹⁴ +
zhàng	ʈʂ a ŋ ⁵¹ +
zhāo	ʈʂ au ⁵⁵ +
zháo	ʈʂ au ³⁵ +
zhǎo	ʈʂ au ²¹⁴ +
zhào	ʈʂ au ⁵¹ +
zhe	ʈʂ ə ⁰ +
zhē	ʈʂ ə ⁵⁵ +
zhé	ʈʂ ə ³⁵ +
zhě	ʈʂ ə ²¹⁴ +
zhè	ʈʂ ə ⁵¹ +
zhēn	ʈʂ ə n ⁵⁵ +
zhén	ʈʂ ə n ³⁵ +
zhěn	ʈʂ ə n ²¹⁴ +
zhèn	ʈʂ ə n ⁵¹ +
zhēng	ʈʂ ə ŋ ⁵⁵ +
zhéng	ʈʂ ə ŋ ³⁵ +
zhěng	ʈʂ ə ŋ ²¹⁴ +
zhèng	ʈʂ ə ŋ ⁵¹ +
zhi	ʈʂ ʅ ⁰ +
zhī	ʈʂ ʅ ⁵⁵ +
zhí	ʈʂ ʅ ³⁵ +
zhǐ	ʈʂ ʅ ²¹⁴ +
zhì	ʈʂ ʅ ⁵¹ +
zhou	ʈʂ ɔu ⁰ +
zhōng	ʈʂ ʊ ŋ ⁵⁵ +
zhóng	ʈʂ ʊ ŋ ³⁵ +
zhǒng	ʈʂ ʊ ŋ ²¹⁴ +
zhòng	ʈʂ ʊ ŋ ⁵¹ +
zhōu	ʈʂ ɔu ⁵⁵ +
zhóu	ʈʂ ɔu ³⁵ +
zhǒu	ʈʂ ɔu ²¹⁴ +
zhòu	ʈʂ ɔu ⁵¹ +
zhuā	ʈʂ w a ⁵⁵ +
zhuá	ʈʂ w a ³⁵ +
zhuǎ	ʈʂ w a ²¹⁴ +
zhuà	ʈʂ w a ⁵¹ +
zhuān	ʈʂ w a n ⁵⁵ +
zhuán	ʈʂ w a n ³⁵ +
zhuǎn	ʈʂ w a n ²¹⁴ +
zhuàn	ʈʂ w a n ⁵¹ +
zhuāng	ʈʂ w a ŋ ⁵⁵ +
zhuáng	ʈʂ w a ŋ ³⁵ +
zhuǎng	ʈʂ w a ŋ ²¹⁴ +
zhuàng	ʈʂ w a ŋ ⁵¹ +
zhuī	ʈʂ w əi ⁵⁵ +
zhuí	ʈʂ w əi ³⁵ +
zhuǐ	ʈʂ w əi ²¹⁴ +
zhuì	ʈʂ w əi ⁵¹ +
zhuō	ʈʂ w ɔ ⁵⁵ +
zhuó	ʈʂ w ɔ ³⁵ +
zhuǒ	ʈʂ w ɔ ²¹⁴ +
zhuò	ʈʂ w ɔ ⁵¹ +
zhū	ʈʂ u ⁵⁵ +
zhú	ʈʂ u ³⁵ +
zhǔ	ʈʂ u ²¹⁴ +
zhù	ʈʂ u ⁵¹ +
zhūn	ʈʂ ʊ n ⁵⁵ +
zhún	ʈʂ ʊ n ³⁵ +
zhǔn	ʈʂ ʊ n ²¹⁴ +
zhùn	ʈʂ ʊ n ⁵¹ +
zi	ts ɿ ⁰ +
zī	ts ɿ ⁵⁵ +
zí	ts ɿ ³⁵ +
zǐ	ts ɿ ²¹⁴ +
zì	ts ɿ ⁵¹ +
zōng	ts ʊ ŋ ⁵⁵ +
zóng	ts ʊ ŋ ³⁵ +
zǒng	ts ʊ ŋ ²¹⁴ +
zòng	ts ʊ ŋ ⁵¹ +
zōu	ts ɔu ⁵⁵ +
zóu	ts ɔu ³⁵ +
zǒu	ts ɔu ²¹⁴ +
zòu	ts ɔu ⁵¹ +
zuān	ts w a n ⁵⁵ +
zuán	ts w a n ³⁵ +
zuǎn	ts w a n ²¹⁴ +
zuàn	ts w a n ⁵¹ +
zuī	ts w əi ⁵⁵ +
zuí	ts w əi ³⁵ +
zuǐ	ts w əi ²¹⁴ +
zuì	ts w əi ⁵¹ +
zuō	ts w ɔ ⁵⁵ +
zuó	ts w ɔ ³⁵ +
zuǒ	ts w ɔ ²¹⁴ +
zuò	ts w ɔ ⁵¹ +
zū	ts u ⁵⁵ +
zú	ts u ³⁵ +
zǔ	ts u ²¹⁴ +
zù	ts u ⁵¹ +
āi$	ai ⁵⁵
ái$	ai ³⁵
ǎi$	ai ²¹⁴
ài$	ai ⁵¹
ān$	a n ⁵⁵
án$	a n ³⁵
ǎn$	a n ²¹⁴
àn$	a n ⁵¹
āng$	a ŋ ⁵⁵
áng$	a ŋ ³⁵
ǎng$	a ŋ ²¹⁴
àng$	a ŋ ⁵¹
āo$	au ⁵⁵
áo$	au ³⁵
ǎo$	au ²¹⁴
ào$	au ⁵¹
ba$	p a ⁰
bā$	p a ⁵⁵
bá$	p a ³⁵
bǎ$	p a ²¹⁴
bà$	p a ⁵¹
bāi$	p ai ⁵⁵
bái$	p ai ³⁵
bǎi$	p ai ²¹⁴
bài$	p ai ⁵¹
bān$	p a n ⁵⁵
bán$	p a n ³⁵
bǎn$	p a n ²¹⁴
bàn$	p a n ⁵¹
bāng$	p a ŋ ⁵⁵
báng$	p a ŋ ³⁵
bǎng$	p a ŋ ²¹⁴
bàng$	p a ŋ ⁵¹
bāo$	p au ⁵⁵
báo$	p au ³⁵
bǎo$	p au ²¹⁴
bào$	p au ⁵¹
bēi$	p ei ⁵⁵
béi$	p ei ³⁵
běi$	p ei ²¹⁴
bèi$	p ei ⁵¹
bēn$	p e n ⁵⁵
bén$	p e n ³⁵
běn$	p e n ²¹⁴
bèn$	p e n ⁵¹
biān$	p j ɛ n ⁵⁵
bián$	p j ɛ n ³⁵
biǎn$	p j ɛ n ²¹⁴
biàn$	p j ɛ n ⁵¹
biāo$	p j au ⁵⁵
biáo$	p j au ³⁵
biǎo$	p j au ²¹⁴
biào$	p j au ⁵¹
biē$	p j ɛ ⁵⁵
bié$	p j ɛ ³⁵
biě$	p j ɛ ²¹⁴
biè$	p j ɛ ⁵¹
bī$	p i ⁵⁵
bí$	p i ³⁵
bǐ$	p i ²¹⁴
bì$	p i ⁵¹
bīn$	p i n ⁵⁵
bín$	p i n ³⁵
bǐn$	p i n ²¹⁴
bìn$	p i n ⁵¹
bīng$	p i ŋ ⁵⁵
bíng$	p i ŋ ³⁵
bǐng$	p i ŋ ²¹⁴
bìng$	p i ŋ ⁵¹
bo$	p w o ⁰
bō$	p w o ⁵⁵
bó$	p w o ³⁵
bǒ$	p w o ²¹⁴
bò$	p w o ⁵¹
bū$	p u ⁵⁵
bú$	p u ³⁵
bǔ$	p u ²¹⁴
bù$	p u ⁵¹
cā$	tsʰ a ⁵⁵
cá$	tsʰ a ³⁵
cǎ$	tsʰ a ²¹⁴
cà$	tsʰ a ⁵¹
cāi$	tsʰ ai ⁵⁵
cái$	tsʰ ai ³⁵
cǎi$	tsʰ ai ²¹⁴
cài$	tsʰ ai ⁵¹
cān$	tsʰ a n ⁵⁵
cán$	tsʰ a n ³⁵
cǎn$	tsʰ a n ²¹⁴
càn$	tsʰ a n ⁵¹
cāng$	tsʰ a ŋ ⁵⁵
cáng$	tsʰ a ŋ ³⁵
cǎng$	tsʰ a ŋ ²¹⁴
càng$	tsʰ a ŋ ⁵¹
cāo$	tsʰ au ⁵⁵
cáo$	tsʰ au ³⁵
cǎo$	tsʰ au ²¹⁴
cào$	tsʰ au ⁵¹
cē$	tsʰ ə ⁵⁵
cé$	tsʰ ə ³⁵
cě$	tsʰ ə ²¹⁴
cè$	tsʰ ə ⁵¹
chā$	ʈʂʰ a ⁵⁵
chá$	ʈʂʰ a ³⁵
chǎ$	ʈʂʰ a ²¹⁴
chà$	ʈʂʰ a ⁵¹
chāi$	ʈʂʰ ai ⁵⁵
chái$	ʈʂʰ ai ³⁵
chǎi$	ʈʂʰ ai ²¹⁴
chài$	ʈʂʰ ai ⁵¹
chān$	ʈʂʰ a n ⁵⁵
chán$	ʈʂʰ a n ³⁵
chǎn$	ʈʂʰ a n ²¹⁴
chàn$	ʈʂʰ a n ⁵¹
chāng$	ʈʂ a ŋ ⁵⁵
cháng$	ʈʂ a ŋ ³⁵
chǎng$	ʈʂ a ŋ ²¹⁴
chàng$	ʈʂ a ŋ ⁵¹
chāo$	ʈʂ au ⁵⁵
cháo$	ʈʂ au ³⁵
chǎo$	ʈʂ au ²¹⁴
chào$	ʈʂ au ⁵¹
chen$	ʈʂ ə n ⁰
chē$	ʈʂ ə ⁵⁵
ché$	ʈʂ ə ³⁵
chě$	ʈʂ ə ²¹⁴
chè$	ʈʂ ə ⁵¹
chēn$	ʈʂ ə n ⁵⁵
chén$	ʈʂ ə n ³⁵
chěn$	ʈʂ ə n ²¹⁴
chèn$	ʈʂ ə n ⁵¹
chēng$	ʈʂ ə ŋ ⁵⁵
chéng$	ʈʂ ə ŋ ³⁵
chěng$	ʈʂ ə ŋ ²¹⁴
chèng$	ʈʂ ə ŋ ⁵¹
chī$	ʈʂ ʅ ⁵⁵
chí$	ʈʂ ʅ ³⁵
chǐ$	ʈʂ ʅ ²¹⁴
chì$	ʈʂ ʅ ⁵¹
chōng$	ʈʂ ʊ ŋ ⁵⁵
chóng$	ʈʂ ʊ ŋ ³⁵
chǒng$	ʈʂ ʊ ŋ ²¹⁴
chòng$	ʈʂ ʊ ŋ ⁵¹
chōu$	ʈʂ ɔu ⁵⁵
chóu$	ʈʂ ɔu ³⁵
chǒu$	ʈʂ ɔu ²¹⁴
chòu$	ʈʂ ɔu ⁵¹
chu$	ʈʂ u ⁰
chuān$	ʈʂ w a n ⁵⁵
chuán$	ʈʂ w a n ³⁵
chuǎn$	ʈʂ w a n ²¹⁴
chuàn$	ʈʂ w a n ⁵¹
chuāng$	ʈʂ w a ŋ ⁵⁵
chuáng$	ʈʂ w a ŋ ³⁵
chuǎng$	ʈʂ w a ŋ ²¹⁴
chuàng$	ʈʂ w a ŋ ⁵¹
chuī$	ʈʂ w əi ⁵⁵
chuí$	ʈʂ w əi ³⁵
chuǐ$	ʈʂ w əi ²¹⁴
chuì$	ʈʂ w əi ⁵¹
chū$	ʈʂ u ⁵⁵
chú$	ʈʂ u ³⁵
chǔ$	ʈʂ u ²¹⁴
chù$	ʈʂ u ⁵¹
chūn$	ʈʂ u n ⁵⁵
chún$	ʈʂ u n ³⁵
chǔn$	ʈʂ u n ²¹⁴
chùn$	ʈʂ u n ⁵¹
cī$	tsʰ ɿ ⁵⁵
cí$	tsʰ ɿ ³⁵
cǐ$	tsʰ ɿ ²¹⁴
cì$	tsʰ ɿ ⁵¹
cōng$	tsʰ ʊ ŋ ⁵⁵
cóng$	tsʰ ʊ ŋ ³⁵
cǒng$	tsʰ ʊ ŋ ²¹⁴
còng$	tsʰ ʊ ŋ ⁵¹
cuō$	tsʰ w ɔ ⁵⁵
cuó$	tsʰ w ɔ ³⁵
cuǒ$	tsʰ w ɔ ²¹⁴
cuò$	tsʰ w ɔ ⁵¹
cū$	tsʰ u ⁵⁵
cú$	tsʰ u ³⁵
cǔ$	tsʰ u ²¹⁴
cù$	tsʰ u ⁵¹
cūn$	tsʰ u n ⁵⁵
cún$	tsʰ u n ³⁵
cǔn$	tsʰ u n ²¹⁴
cùn$	tsʰ u n ⁵¹
dā$	t a ⁵⁵
dá$	t a ³⁵
dǎ$	t a ²¹⁴
dà$	t a ⁵¹
dāi$	t ai ⁵⁵
dái$	t ai ³⁵
dǎi$	t ai ²¹⁴
dài$	t ai ⁵¹
dān$	t a n ⁵⁵
dán$	t a n ³⁵
dǎn$	t a n ²¹⁴
dàn$	t a n ⁵¹
dāo$	t au ⁵⁵
dáo$	t au ³⁵
dǎo$	t au ²¹⁴
dào$	t au ⁵¹
de$	t ə ⁰
dē$	t ə ⁵⁵
dé$	t ə ³⁵
dě$	t ə ²¹⁴
dè$	t ə ⁵¹
dēng$	t ə ŋ ⁵⁵
déng$	t ə ŋ ³⁵
děng$	t ə ŋ ²¹⁴
dèng$	t ə ŋ ⁵¹
di$	t i ⁰
diān$	t j ɛ n ⁵⁵
dián$	t j ɛ n ³⁵
diǎn$	t j ɛ n ²¹⁴
diàn$	t j ɛ n ⁵¹
diāo$	t j au ⁵⁵
diáo$	t j au ³⁵
diǎo$	t j au ²¹⁴
diào$	t j au ⁵¹
diē$	t j ə ⁵⁵
dié$	t j ə ³⁵
diě$	t j ə ²¹⁴
diè$	t j ə ⁵¹
dī$	t i ⁵⁵
dí$	t i ³⁵
dǐ$	t i ²¹⁴
dì$	t i ⁵¹
dīng$	t i ŋ ⁵⁵
díng$	t i ŋ ³⁵
dǐng$	t i ŋ ²¹⁴
dìng$	t i ŋ ⁵¹
dōng$	t ʊ ŋ ⁵⁵
dóng$	t ʊ ŋ ³⁵
dǒng$	t ʊ ŋ ²¹⁴
dòng$	t ʊ ŋ ⁵¹
dōu$	t ɔu ⁵⁵
dóu$	t ɔu ³⁵
dǒu$	t ɔu ²¹⁴
dòu$	t ɔu ⁵¹
duān$	t w a n ⁵⁵
duán$	t w a n ³⁵
duǎn$	t w a n ²¹⁴
duàn$	t w a n ⁵¹
duī$	t w əi ⁵⁵
duí$	t w əi ³⁵
duǐ$	t w əi ²¹⁴
duì$	t w əi ⁵¹
duo$	t w ɔ ⁰
duō$	t w ɔ ⁵⁵
duó$	t w ɔ ³⁵
duǒ$	t w ɔ ²¹⁴
duò$	t w ɔ ⁵¹
dū$	t u ⁵⁵
dú$	t u ³⁵
dǔ$	t u ²¹⁴
dù$	t u ⁵¹
dūn$	t ʊ n ⁵⁵
dún$	t ʊ n ³⁵
dǔn$	t ʊ n ²¹⁴
dùn$	t ʊ n ⁵¹
e$	ə ⁰
ē$	ə ⁵⁵
é$	ə ³⁵
ě$	ə ²¹⁴
è$	ə ⁵¹
ēr$	ɚ ⁵⁵
ér$	ɚ ³⁵
ěr$	ɚ ²¹⁴
èr$	ɚ ⁵¹
fa$	f a ⁰
fā$	f a ⁵⁵
fá$	f a ³⁵
fǎ$	f a ²¹⁴
fà$	f a ⁵¹
fān$	f a n ⁵⁵
fán$	f a n ³⁵
fǎn$	f a n ²¹⁴
fàn$	f a n ⁵¹
fāng$	f a ŋ ⁵⁵
fáng$	f a ŋ ³⁵
fǎng$	f a ŋ ²¹⁴
fàng$	f a ŋ ⁵¹
fen$	f ə n ⁰
feng$	f ə ŋ ⁰
fēi$	f əi ⁵⁵
féi$	f əi ³⁵
fěi$	f əi ²¹⁴
fèi$	f əi ⁵¹
fēn$	f ə n ⁵⁵
fén$	f ə n ³⁵
fěn$	f ə n ²¹⁴
fèn$	f ə n ⁵¹
fēng$	f ə ŋ ⁵⁵
féng$	f ə ŋ ³⁵
fěng$	f ə ŋ ²¹⁴
fèng$	f ə ŋ ⁵¹
fōu$	f ɔu ⁵⁵
fóu$	f ɔu ³⁵
fǒu$	f ɔu ²¹⁴
fòu$	f ɔu ⁵¹
fu$	f u ⁰
fū$	f u ⁵⁵
fú$	f u ³⁵
fǔ$	f u ²¹⁴
fù$	f u ⁵¹
gāi$	k ai ⁵⁵
gái$	k ai ³⁵
gǎi$	k ai ²¹⁴
gài$	k ai ⁵¹
gān$	k a n ⁵⁵
gán$	k a n ³⁵
gǎn$	k a n ²¹⁴
gàn$	k a n ⁵¹
gāng$	k a ŋ ⁵⁵
gáng$	k a ŋ ³⁵
gǎng$	k a ŋ ²¹⁴
gàng$	k a ŋ ⁵¹
gāo$	k au ⁵⁵
gáo$	k au ³⁵
gǎo$	k au ²¹⁴
gào$	k au ⁵¹
ge$	k ə ⁰
gē$	k ə ⁵⁵
gé$	k ə ³⁵
gě$	k ə ²¹⁴
gè$	k ə ⁵¹
gēi$	k əi ⁵⁵
géi$	k əi ³⁵
gěi$	k əi ²¹⁴
gèi$	k əi ⁵¹
gēn$	k ə n ⁵⁵
gén$	k ə n ³⁵
gěn$	k ə n ²¹⁴
gèn$	k ə n ⁵¹
gēng$	k ə ŋ ⁵⁵
géng$	k ə ŋ ³⁵
gěng$	k ə ŋ ²¹⁴
gèng$	k ə ŋ ⁵¹
gong$	k ʊ ŋ ⁰
gōng$	k ʊ ŋ ⁵⁵
góng$	k ʊ ŋ ³⁵
gǒng$	k ʊ ŋ ²¹⁴
gòng$	k ʊ ŋ ⁵¹
gōu$	k ɔu ⁵⁵
góu$	k ɔu ³⁵
gǒu$	k ɔu ²¹⁴
gòu$	k ɔu ⁵¹
gu$	k u ⁰
guā$	k w a ⁵⁵
guá$	k w a ³⁵
guǎ$	k w a ²¹⁴
guà$	k w a ⁵¹
guāi$	k w ai ⁵⁵
guái$	k w ai ³⁵
guǎi$	k w ai ²¹⁴
guài$	k w ai ⁵¹
guān$	k w a n ⁵⁵
guán$	k w a n ³⁵
guǎn$	k w a n ²¹⁴
guàn$	k w a n ⁵¹
guāng$	k w a ŋ ⁵⁵
guáng$	k w a ŋ ³⁵
guǎng$	k w a ŋ ²¹⁴
guàng$	k w a ŋ ⁵¹
guī$	k w əi ⁵⁵
guí$	k w əi ³⁵
guǐ$	k w əi ²¹⁴
guì$	k w əi ⁵¹
guō$	k w ɔ ⁵⁵
guó$	k w ɔ ³⁵
guǒ$	k w ɔ ²¹⁴
guò$	k w ɔ ⁵¹
gū$	k u ⁵⁵
gú$	k u ³⁵
gǔ$	k u ²¹⁴
gù$	k u ⁵¹
gūn$	k ʊ n ⁵⁵
gún$	k ʊ n ³⁵
gǔn$	k ʊ n ²¹⁴
gùn$	k ʊ n ⁵¹
hā$	x a ⁵⁵
há$	x a ³⁵
hǎ$	x a ²¹⁴
hà$	x a ⁵¹
hāi$	x ai ⁵⁵
hái$	x ai ³⁵
hǎi$	x ai ²¹⁴
hài$	x ai ⁵¹
hān$	x a n ⁵⁵
hán$	x a n ³⁵
hǎn$	x a n ²¹⁴
hàn$	x a n ⁵¹
hāng$	x a ŋ ⁵⁵
háng$	x a ŋ ³⁵
hǎng$	x a ŋ ²¹⁴
hàng$	x a ŋ ⁵¹
hāo$	x au ⁵⁵
háo$	x au ³⁵
hǎo$	x au ²¹⁴
hào$	x au ⁵¹
hē$	x ə ⁵⁵
hé$	x ə ³⁵
hě$	x ə ²¹⁴
hè$	x ə ⁵¹
hēi$	x əi ⁵⁵
héi$	x əi ³⁵
hěi$	x əi ²¹⁴
hèi$	x əi ⁵¹
hēn$	x ə n ⁵⁵
hén$	x ə n ³⁵
hěn$	x ə n ²¹⁴
hèn$	x ə n ⁵¹
hēng$	x ə ŋ ⁵⁵
héng$	x ə ŋ ³⁵
hěng$	x ə ŋ ²¹⁴
hèng$	x ə ŋ ⁵¹
hōng$	x ʊ ŋ ⁵⁵
hóng$	x ʊ ŋ ³⁵
hǒng$	x ʊ ŋ ²¹⁴
hòng$	x ʊ ŋ ⁵¹
hōu$	x ɔu ⁵⁵
hóu$	x ɔu ³⁵
hǒu$	x ɔu ²¹⁴
hòu$	x ɔu ⁵¹
hu$	x u ⁰
huā$	x w a ⁵⁵
huá$	x w a ³⁵
huǎ$	x w a ²¹⁴
huà$	x w a ⁵¹
huāi$	x w ai ⁵⁵
huái$	x w ai ³⁵
huǎi$	x w ai ²¹⁴
huài$	x w ai ⁵¹
huān$	x w a n ⁵⁵
huán$	x w a n ³⁵
huǎn$	x w a n ²¹⁴
huàn$	x w a n ⁵¹
huāng$	x w a ŋ ⁵⁵
huáng$	x w a ŋ ³⁵
huǎng$	x w a ŋ ²¹⁴
huàng$	x w a ŋ ⁵¹
huī$	x w əi ⁵⁵
huí$	x w əi ³⁵
huǐ$	x w əi ²¹⁴
huì$	x w əi ⁵¹
huō$	x w ɔ ⁵⁵
huó$	x w ɔ ³⁵
huǒ$	x w ɔ ²¹⁴
huò$	x w ɔ ⁵¹
hū$	x u ⁵⁵
hú$	x u ³⁵
hǔ$	x u ²¹⁴
hù$	x u ⁵¹
hūn$	x ʊ n ⁵⁵
hún$	x ʊ n ³⁵
hǔn$	x ʊ n ²¹⁴
hùn$	x ʊ n ⁵¹
jiā$	tɕ j a ⁵⁵
jiá$	tɕ j a ³⁵
jiǎ$	tɕ j a ²¹⁴
jià$	tɕ j a ⁵¹
jiān$	tɕ j ɛ n ⁵⁵
jián$	tɕ j ɛ n ³⁵
jiǎn$	tɕ j ɛ n ²¹⁴
jiàn$	tɕ j ɛ n ⁵¹
jiāng$	tɕ j a ŋ ⁵⁵
jiáng$	tɕ j a ŋ ³⁵
jiǎng$	tɕ j a ŋ ²¹⁴
jiàng$	tɕ j a ŋ ⁵¹
jiāo$	tɕ j au ⁵⁵
jiáo$	tɕ j au ³⁵
jiǎo$	tɕ j au ²¹⁴
jiào$	tɕ j au ⁵¹
jie$	tɕ j ə ⁰
jiē$	tɕ j ə ⁵⁵
jié$	tɕ j ə ³⁵
jiě$	tɕ j ə ²¹⁴
jiè$	tɕ j ə ⁵¹
jing$	tɕ i ŋ ⁰
jiū$	tɕ j ɔu ⁵⁵
jiú$	tɕ j ɔu ³⁵
jiǔ$	tɕ j ɔu ²¹⁴
jiù$	tɕ j ɔu ⁵¹
jī$	tɕ i ⁵⁵
jí$	tɕ i ³⁵
jǐ$	tɕ i ²¹⁴
jì$	tɕ i ⁵¹
jīn$	tɕ i n ⁵⁵
jín$	tɕ i n ³⁵
jǐn$	tɕ i n ²¹⁴
jìn$	tɕ i n ⁵¹
jīng$	tɕ i ŋ ⁵⁵
jíng$	tɕ i ŋ ³⁵
jǐng$	tɕ i ŋ ²¹⁴
jìng$	tɕ i ŋ ⁵¹
jīnɡ$	tɕ i ŋ ⁵⁵
jínɡ$	tɕ i ŋ ³⁵
jǐnɡ$	tɕ i ŋ ²¹⁴
jìnɡ$	tɕ i ŋ ⁵¹
juē$	tɕ ɥ ə ⁵⁵
jué$	tɕ ɥ ə ³⁵
juě$	tɕ ɥ ə ²¹⁴
juè$	tɕ ɥ ə ⁵¹
jū$	tɕ y ⁵⁵
jú$	tɕ y ³⁵
jǔ$	tɕ y ²¹⁴
jù$	tɕ y ⁵¹
jūn$	tɕ y n ⁵⁵
jún$	tɕ y n ³⁵
jǔn$	tɕ y n ²¹⁴
jùn$	tɕ y n ⁵¹
kāi$	kʰ ai ⁵⁵
kái$	kʰ ai ³⁵
kǎi$	kʰ ai ²¹⁴
kài$	kʰ ai ⁵¹
kān$	kʰ a n ⁵⁵
kán$	kʰ a n ³⁵
kǎn$	kʰ a n ²¹⁴
kàn$	kʰ a n ⁵¹
kāng$	kʰ a ŋ ⁵⁵
káng$	kʰ a ŋ ³⁵
kǎng$	kʰ a ŋ ²¹⁴
kàng$	kʰ a ŋ ⁵¹
kāo$	kʰ au ⁵⁵
káo$	kʰ au ³⁵
kǎo$	kʰ au ²¹⁴
kào$	kʰ au ⁵¹
kē$	kʰ ə ⁵⁵
ké$	kʰ ə ³⁵
kě$	kʰ ə ²¹⁴
kè$	kʰ ə ⁵¹
kōng$	kʰ ʊ ŋ ⁵⁵
kóng$	kʰ ʊ ŋ ³⁵
kǒng$	kʰ ʊ ŋ ²¹⁴
kòng$	kʰ ʊ ŋ ⁵¹
kōu$	kʰ ɔu ⁵⁵
kóu$	kʰ ɔu ³⁵
kǒu$	kʰ ɔu ²¹⁴
kòu$	kʰ ɔu ⁵¹
kuā$	kʰ w a ⁵⁵
kuá$	kʰ w a ³⁵
kuǎ$	kʰ w a ²¹⁴
kuà$	kʰ w a ⁵¹
kuāi$	kʰ w ai ⁵⁵
kuái$	kʰ w ai ³⁵
kuǎi$	kʰ w ai ²¹⁴
kuài$	kʰ w ai ⁵¹
kuān$	kʰ w a n ⁵⁵
kuán$	kʰ w a n ³⁵
kuǎn$	kʰ w a n ²¹⁴
kuàn$	kʰ w a n ⁵¹
kuāng$	kʰ w a ŋ ⁵⁵
kuáng$	kʰ w a ŋ ³⁵
kuǎng$	kʰ w a ŋ ²¹⁴
kuàng$	kʰ w a ŋ ⁵¹
kuī$	kʰ w əi ⁵⁵
kuí$	kʰ w əi ³⁵
kuǐ$	kʰ w əi ²¹⁴
kuì$	kʰ w əi ⁵¹
kū$	kʰ u ⁵⁵
kú$	kʰ u ³⁵
kǔ$	kʰ u ²¹⁴
kù$	kʰ u ⁵¹
kūn$	kʰ ʊ n ⁵⁵
kún$	kʰ ʊ n ³⁵
kǔn$	kʰ ʊ n ²¹⁴
kùn$	kʰ ʊ n ⁵¹
lā$	l a ⁵⁵
lá$	l a ³⁵
lǎ$	l a ²¹⁴
là$	l a ⁵¹
lāi$	l ai ⁵⁵
lái$	l ai ³⁵
lǎi$	l ai ²¹⁴
lài$	l ai ⁵¹
lān$	l a n ⁵⁵
lán$	l a n ³⁵
lǎn$	l a n ²¹⁴
làn$	l a n ⁵¹
lāng$	l a ŋ ⁵⁵
láng$	l a ŋ ³⁵
lǎng$	l a ŋ ²¹⁴
làng$	l a ŋ ⁵¹
lāo$	l au ⁵⁵
láo$	l au ³⁵
lǎo$	l au ²¹⁴
lào$	l au ⁵¹
lē$	l ə ⁵⁵
lé$	l ə ³⁵
lě$	l ə ²¹⁴
lè$	l ə ⁵¹
lēi$	l əi ⁵⁵
léi$	l əi ³⁵
lěi$	l əi ²¹⁴
lèi$	l əi ⁵¹
lēng$	l ə ŋ ⁵⁵
léng$	l ə ŋ ³⁵
lěng$	l ə ŋ ²¹⁴
lèng$	l ə ŋ ⁵¹
li$	l i ⁰
liān$	l j ɛ n ⁵⁵
lián$	l j ɛ n ³⁵
liǎn$	l j ɛ n ²¹⁴
liàn$	l j ɛ n ⁵¹
liāng$	l j a ŋ ⁵⁵
liáng$	l j a ŋ ³⁵
liǎng$	l j a ŋ ²¹⁴
liàng$	l j a ŋ ⁵¹
liāo$	l j au ⁵⁵
liáo$	l j au ³⁵
liǎo$	l j au ²¹⁴
liào$	l j au ⁵¹
liē$	l j ə ⁵⁵
lié$	l j ə ³⁵
liě$	l j ə ²¹⁴
liè$	l j ə ⁵¹
liū$	l j ɔu ⁵⁵
liú$	l j ɔu ³⁵
liǔ$	l j ɔu ²¹⁴
liù$	l j ɔu ⁵¹
lī$	l i ⁵⁵
lí$	l i ³⁵
lǐ$	l i ²¹⁴
lì$	l i ⁵¹
līn$	l i n ⁵⁵
lín$	l i n ³⁵
lǐn$	l i n ²¹⁴
lìn$	l i n ⁵¹
līng$	l i ŋ ⁵⁵
líng$	l i ŋ ³⁵
lǐng$	l i ŋ ²¹⁴
lìng$	l i ŋ ⁵¹
lōng$	l ʊ ŋ ⁵⁵
lóng$	l ʊ ŋ ³⁵
lǒng$	l ʊ ŋ ²¹⁴
lòng$	l ʊ ŋ ⁵¹
lōu$	l ɔu ⁵⁵
lóu$	l ɔu ³⁵
lǒu$	l ɔu ²¹⁴
lòu$	l ɔu ⁵¹
lu$	l u ⁰
luān$	l w a n ⁵⁵
luán$	l w a n ³⁵
luǎn$	l w a n ²¹⁴
luàn$	l w a n ⁵¹
luō$	l w ɔ ⁵⁵
luó$	l w ɔ ³⁵
luǒ$	l w ɔ ²¹⁴
luò$	l w ɔ ⁵¹
lū$	l u ⁵⁵
lú$	l u ³⁵
lǔ$	l u ²¹⁴
lù$	l u ⁵¹
lūn$	l ʊ n ⁵⁵
lún$	l ʊ n ³⁵
lǔn$	l ʊ n ²¹⁴
lùn$	l ʊ n ⁵¹
mao$	m au ⁰
mā$	m a ⁵⁵
má$	m a ³⁵
mǎ$	m a ²¹⁴
mà$	m a ⁵¹
māi$	m ai ⁵⁵
mái$	m ai ³⁵
mǎi$	m ai ²¹⁴
mài$	m ai ⁵¹
mān$	m a n ⁵⁵
mán$	m a n ³⁵
mǎn$	m a n ²¹⁴
màn$	m a n ⁵¹
māng$	m a ŋ ⁵⁵
máng$	m a ŋ ³⁵
mǎng$	m a ŋ ²¹⁴
màng$	m a ŋ ⁵¹
māo$	m au ⁵⁵
máo$	m au ³⁵
mǎo$	m au ²¹⁴
mào$	m au ⁵¹
mei$	m əi ⁰
men$	m ə n ⁰
mēi$	m əi ⁵⁵
méi$	m əi ³⁵
měi$	m əi ²¹⁴
mèi$	m əi ⁵¹
mēn$	m ə n ⁵⁵
mén$	m ə n ³⁵
měn$	m ə n ²¹⁴
mèn$	m ə n ⁵¹
mēng$	m ə ŋ ⁵⁵
méng$	m ə ŋ ³⁵
měng$	m ə ŋ ²¹⁴
mèng$	m ə ŋ ⁵¹
miān$	m j ɛ n ⁵⁵
mián$	m j ɛ n ³⁵
miǎn$	m j ɛ n ²¹⁴
miàn$	m j ɛ n ⁵¹
miāo$	m j au ⁵⁵
miáo$	m j au ³⁵
miǎo$	m j au ²¹⁴
miào$	m j au ⁵¹
miē$	m j ə ⁵⁵
mié$	m j ə ³⁵
miě$	m j ə ²¹⁴
miè$	m j ə ⁵¹
ming$	m i ŋ ⁰
mī$	m i ⁵⁵
mí$	m i ³⁵
mǐ$	m i ²¹⁴
mì$	m i ⁵¹
mīn$	m i n ⁵⁵
mín$	m i n ³⁵
mǐn$	m i n ²¹⁴
mìn$	m i n ⁵¹
mīng$	m i ŋ ⁵⁵
míng$	m i ŋ ³⁵
mǐng$	m i ŋ ²¹⁴
mìng$	m i ŋ ⁵¹
mō$	m w ɔ ⁵⁵
mó$	m w ɔ ³⁵
mǒ$	m w ɔ ²¹⁴
mò$	m w ɔ ⁵¹
mōu$	m ɔu ⁵⁵
móu$	m ɔu ³⁵
mǒu$	m ɔu ²¹⁴
mòu$	m ɔu ⁵¹
mū$	m u ⁵⁵
mú$	m u ³⁵
mǔ$	m u ²¹⁴
mù$	m u ⁵¹
nā$	n a ⁵⁵
ná$	n a ³⁵
nǎ$	n a ²¹⁴
nà$	n a ⁵¹
nāi$	n ai ⁵⁵
nái$	n ai ³⁵
nǎi$	n ai ²¹⁴
nài$	n ai ⁵¹
nān$	n a n ⁵⁵
nán$	n a n ³⁵
nǎn$	n a n ²¹⁴
nàn$	n a n ⁵¹
nāo$	n au ⁵⁵
náo$	n au ³⁵
nǎo$	n au ²¹⁴
nào$	n au ⁵¹
niān$	n j ɛ n ⁵⁵
nián$	n j ɛ n ³⁵
niǎn$	n j ɛ n ²¹⁴
niàn$	n j ɛ n ⁵¹
niāo$	n j au ⁵⁵
niáo$	n j au ³⁵
niǎo$	n j au ²¹⁴
niào$	n j au ⁵¹
niē$	n j ə ⁵⁵
nié$	n j ə ³⁵
niě$	n j ə ²¹⁴
niè$	n j ə ⁵¹
niū$	n j ɔu ⁵⁵
niú$	n j ɔu ³⁵
niǔ$	n j ɔu ²¹⁴
niù$	n j ɔu ⁵¹
nī$	n i ⁵⁵
ní$	n i ³⁵
nǐ$	n i ²¹⁴
nì$	n i ⁵¹
nīng$	n i ŋ ⁵⁵
níng$	n i ŋ ³⁵
nǐng$	n i ŋ ²¹⁴
nìng$	n i ŋ ⁵¹
nong$	n ʊ ŋ ⁰
nōng$	n ʊ ŋ ⁵⁵
nóng$	n ʊ ŋ ³⁵
nǒng$	n ʊ ŋ ²¹⁴
nòng$	n ʊ ŋ ⁵¹
nuān$	n w a n ⁵⁵
nuán$	n w a n ³⁵
nuǎn$	n w a n ²¹⁴
nuàn$	n w a n ⁵¹
nuō$	n w ɔ ⁵⁵
nuó$	n w ɔ ³⁵
nuǒ$	n w ɔ ²¹⁴
nuò$	n w ɔ ⁵¹
nū$	n u ⁵⁵
nú$	n u ³⁵
nǔ$	n u ²¹⁴
nù$	n u ⁵¹
ōu$	ɔu ⁵⁵
óu$	ɔu ³⁵
ǒu$	ɔu ²¹⁴
òu$	ɔu ⁵¹
pā$	pʰ a ⁵⁵
pá$	pʰ a ³⁵
pǎ$	pʰ a ²¹⁴
pà$	pʰ a ⁵¹
pāi$	pʰ ai ⁵⁵
pái$	pʰ ai ³⁵
pǎi$	pʰ ai ²¹⁴
pài$	pʰ ai ⁵¹
pān$	pʰ a n ⁵⁵
pán$	pʰ a n ³⁵
pǎn$	pʰ a n ²¹⁴
pàn$	pʰ a n ⁵¹
pāng$	pʰ a ŋ ⁵⁵
páng$	pʰ a ŋ ³⁵
pǎng$	pʰ a ŋ ²¹⁴
pàng$	pʰ a ŋ ⁵¹
pāo$	pʰ au ⁵⁵
páo$	pʰ au ³⁵
pǎo$	pʰ au ²¹⁴
pào$	pʰ au ⁵¹
peng$	pʰ ə ŋ ⁰
pēi$	pʰ əi ⁵⁵
péi$	pʰ əi ³⁵
pěi$	pʰ əi ²¹⁴
pèi$	pʰ əi ⁵¹
pēn$	pʰ ə n ⁵⁵
pén$	pʰ ə n ³⁵
pěn$	pʰ ə n ²¹⁴
pèn$	pʰ ə n ⁵¹
pēng$	pʰ ə ŋ ⁵⁵
péng$	pʰ ə ŋ ³⁵
pěng$	pʰ ə ŋ ²¹⁴
pèng$	pʰ ə ŋ ⁵¹
piān$	pʰ j ɛ n ⁵⁵
pián$	pʰ j ɛ n ³⁵
piǎn$	pʰ j ɛ n ²¹⁴
piàn$	pʰ j ɛ n ⁵¹
pī$	pʰ i ⁵⁵
pí$	pʰ i ³⁵
pǐ$	pʰ i ²¹⁴
pì$	pʰ i ⁵¹
pīn$	pʰ i n ⁵⁵
pín$	pʰ i n ³⁵
pǐn$	pʰ i n ²¹⁴
pìn$	pʰ i n ⁵¹
pīng$	pʰ i ŋ ⁵⁵
píng$	pʰ i ŋ ³⁵
pǐng$	pʰ i ŋ ²¹⁴
pìng$	pʰ i ŋ ⁵¹
po$	pʰ w ɔ ⁰
pō$	pʰ w ɔ ⁵⁵
pó$	pʰ w ɔ ³⁵
pǒ$	pʰ w ɔ ²¹⁴
pò$	pʰ w ɔ ⁵¹
pū$	pʰ u ⁵⁵
pú$	pʰ u ³⁵
pǔ$	pʰ u ²¹⁴
pù$	pʰ u ⁵¹
qi$	tɕʰ ⁰
qian$	tɕʰ j ɛ n ⁰
qiā$	tɕʰ j a ⁵⁵
qiá$	tɕʰ j a ³⁵
qiǎ$	tɕʰ j a ²¹⁴
qià$	tɕʰ j a ⁵¹
qiān$	tɕʰ j ɛ n ⁵⁵
qián$	tɕʰ j ɛ n ³⁵
qiǎn$	tɕʰ j ɛ n ²¹⁴
qiàn$	tɕʰ j ɛ n ⁵¹
qiāng$	tɕʰ j a ŋ ⁵⁵
qiáng$	tɕʰ j a ŋ ³⁵
qiǎng$	tɕʰ j a ŋ ²¹⁴
qiàng$	tɕʰ j a ŋ ⁵¹
qiāo$	tɕʰ j au ⁵⁵
qiáo$	tɕʰ j au ³⁵
qiǎo$	tɕʰ j au ²¹⁴
qiào$	tɕʰ j au ⁵¹
qiē$	tɕʰ j ə ⁵⁵
qié$	tɕʰ j ə ³⁵
qiě$	tɕʰ j ə ²¹⁴
qiè$	tɕʰ j ə ⁵¹
qin$	tɕʰ i n ⁰
qing$	tɕʰ i ŋ ⁰
qiōng$	tɕʰ j ʊ ŋ ⁵⁵
qióng$	tɕʰ j ʊ ŋ ³⁵
qiǒng$	tɕʰ j ʊ ŋ ²¹⁴
qiòng$	tɕʰ j ʊ ŋ ⁵¹
qiū$	tɕʰ j ɔu ⁵⁵
qiú$	tɕʰ j ɔu ³⁵
qiǔ$	tɕʰ j ɔu ²¹⁴
qiù$	tɕʰ j ɔu ⁵¹
qī$	tɕʰ i ⁵⁵
qí$	tɕʰ i ³⁵
qǐ$	tɕʰ i ²¹⁴
qì$	tɕʰ i ⁵¹
qīn$	tɕʰ i n ⁵⁵
qín$	tɕʰ i n ³⁵
qǐn$	tɕʰ i n ²¹⁴
qìn$	tɕʰ i n ⁵¹
qīng$	tɕʰ i ŋ ⁵⁵
qíng$	tɕʰ i ŋ ³⁵
qǐng$	tɕʰ i ŋ ²¹⁴
qìng$	tɕʰ i ŋ ⁵¹
quān$	tɕʰ ɥ ɛ n ⁵⁵
quán$	tɕʰ ɥ ɛ n ³⁵
quǎn$	tɕʰ ɥ ɛ n ²¹⁴
quàn$	tɕʰ ɥ ɛ n ⁵¹
quē$	tɕʰ ɥ ə ⁵⁵
qué$	tɕʰ ɥ ə ³⁵
quě$	tɕʰ ɥ ə ²¹⁴
què$	tɕʰ ɥ ə ⁵¹
qū$	tɕʰ y ⁵⁵
qú$	tɕʰ y ³⁵
qǔ$	tɕʰ y ²¹⁴
qù$	tɕʰ y ⁵¹
qūn$	tɕʰ y n ⁵⁵
qún$	tɕʰ y n ³⁵
qǔn$	tɕʰ y n ²¹⁴
qùn$	tɕʰ y n ⁵¹
rān$	ʐ a n ⁵⁵
rán$	ʐ a n ³⁵
rǎn$	ʐ a n ²¹⁴
ràn$	ʐ a n ⁵¹
rāo$	ʐ au ⁵⁵
ráo$	ʐ au ³⁵
rǎo$	ʐ au ²¹⁴
rào$	ʐ au ⁵¹
rē$	ʐ ə ⁵⁵
ré$	ʐ ə ³⁵
rě$	ʐ ə ²¹⁴
rè$	ʐ ə ⁵¹
rēn$	ʐ ə n ⁵⁵
rén$	ʐ ə n ³⁵
rěn$	ʐ ə n ²¹⁴
rèn$	ʐ ə n ⁵¹
rēng$	ʐ ə ŋ ⁵⁵
réng$	ʐ ə ŋ ³⁵
rěng$	ʐ ə ŋ ²¹⁴
rèng$	ʐ ə ŋ ⁵¹
rī$	ʐ ʅ ⁵⁵
rí$	ʐ ʅ ³⁵
rǐ$	ʐ ʅ ²¹⁴
rì$	ʐ ʅ ⁵¹
rōng$	ʐ ʊ ŋ ⁵⁵
róng$	ʐ ʊ ŋ ³⁵
rǒng$	ʐ ʊ ŋ ²¹⁴
ròng$	ʐ ʊ ŋ ⁵¹
rōu$	ʐ ɔu ⁵⁵
róu$	ʐ ɔu ³⁵
rǒu$	ʐ ɔu ²¹⁴
ròu$	ʐ ɔu ⁵¹
ruān$	ʐ w a n ⁵⁵
ruán$	ʐ w a n ³⁵
ruǎn$	ʐ w a n ²¹⁴
ruàn$	ʐ w a n ⁵¹
ruō$	ʐ w ɔ ⁵⁵
ruó$	ʐ w ɔ ³⁵
ruǒ$	ʐ w ɔ ²¹⁴
ruò$	ʐ w ɔ ⁵¹
rū$	ʐ u ⁵⁵
rú$	ʐ u ³⁵
rǔ$	ʐ u ²¹⁴
rù$	ʐ u ⁵¹
sāi$	s ai ⁵⁵
sái$	s ai ³⁵
sǎi$	s ai ²¹⁴
sài$	s ai ⁵¹
sān$	s a n ⁵⁵
sán$	s a n ³⁵
sǎn$	s a n ²¹⁴
sàn$	s a n ⁵¹
sāo$	s au ⁵⁵
sáo$	s au ³⁵
sǎo$	s au ²¹⁴
sào$	s au ⁵¹
sē$	s ə ⁵⁵
sé$	s ə ³⁵
sě$	s ə ²¹⁴
sè$	s ə ⁵¹
sēn$	s ə n ⁵⁵
sén$	s ə n ³⁵
sěn$	s ə n ²¹⁴
sèn$	s ə n ⁵¹
shang$	ʂ a ŋ ⁰
shā$	ʂ a ⁵⁵
shá$	ʂ a ³⁵
shǎ$	ʂ a ²¹⁴
shà$	ʂ a ⁵¹
shāi$	ʂ ai ⁵⁵
shái$	ʂ ai ³⁵
shǎi$	ʂ ai ²¹⁴
shài$	ʂ ai ⁵¹
shān$	ʂ a n ⁵⁵
shán$	ʂ a n ³⁵
shǎn$	ʂ a n ²¹⁴
shàn$	ʂ a n ⁵¹
shāng$	ʂ a ŋ ⁵⁵
sháng$	ʂ a ŋ ³⁵
shǎng$	ʂ a ŋ ²¹⁴
shàng$	ʂ a ŋ ⁵¹
shāo$	ʂ au ⁵⁵
sháo$	ʂ au ³⁵
shǎo$	ʂ au ²¹⁴
shào$	ʂ au ⁵¹
sheng$	ʂ ə ŋ ⁰
shē$	ʂ ə ⁵⁵
shé$	ʂ ə ³⁵
shě$	ʂ ə ²¹⁴
shè$	ʂ ə ⁵¹
shēn$	ʂ ə n ⁵⁵
shén$	ʂ ə n ³⁵
shěn$	ʂ ə n ²¹⁴
shèn$	ʂ ə n ⁵¹
shēng$	ʂ ə ŋ ⁵⁵
shéng$	ʂ ə ŋ ³⁵
shěng$	ʂ ə ŋ ²¹⁴
shèng$	ʂ ə ŋ ⁵¹
shēnɡ$	ʂ ə ŋ ⁵⁵
shénɡ$	ʂ ə ŋ ³⁵
shěnɡ$	ʂ ə ŋ ²¹⁴
shènɡ$	ʂ ə ŋ ⁵¹
shi$	ʂ ʅ ⁰
shī$	ʂ ʅ ⁵⁵
shí$	ʂ ʅ ³⁵
shǐ$	ʂ ʅ ²¹⁴
shì$	ʂ ʅ ⁵¹
shōu$	ʂ ɔu ⁵⁵
shóu$	ʂ ɔu ³⁵
shǒu$	ʂ ɔu ²¹⁴
shòu$	ʂ ɔu ⁵¹
shuā$	ʂ w a ⁵⁵
shuá$	ʂ w a ³⁵
shuǎ$	ʂ w a ²¹⁴
shuà$	ʂ w a ⁵¹
shuān$	ʂ w a n ⁵⁵
shuán$	ʂ w a n ³⁵
shuǎn$	ʂ w a n ²¹⁴
shuàn$	ʂ w a n ⁵¹
shuāng$	ʂ w a ŋ ⁵⁵
shuáng$	ʂ w a ŋ ³⁵
shuǎng$	ʂ w a ŋ ²¹⁴
shuàng$	ʂ w a ŋ ⁵¹
shuī$	ʂ w əi ⁵⁵
shuí$	ʂ w əi ³⁵
shuǐ$	ʂ w əi ²¹⁴
shuì$	ʂ w əi ⁵¹
shuō$	ʂ w ɔ ⁵⁵
shuó$	ʂ w ɔ ³⁵
shuǒ$	ʂ w ɔ ²¹⁴
shuò$	ʂ w ɔ ⁵¹
shū$	ʂ u ⁵⁵
shú$	ʂ u ³⁵
shǔ$	ʂ u ²¹⁴
shù$	ʂ u ⁵¹
sī$	s ɿ ⁵⁵
sí$	s ɿ ³⁵
sǐ$	s ɿ ²¹⁴
sì$	s ɿ ⁵¹
sōng$	s ʊ ŋ ⁵⁵
sóng$	s ʊ ŋ ³⁵
sǒng$	s ʊ ŋ ²¹⁴
sòng$	s ʊ ŋ ⁵¹
suān$	s w a n ⁵⁵
suán$	s w a n ³⁵
suǎn$	s w a n ²¹⁴
suàn$	s w a n ⁵¹
suī$	s w əi ⁵⁵
suí$	s w əi ³⁵
suǐ$	s w əi ²¹⁴
suì$	s w əi ⁵¹
suō$	s w ɔ ⁵⁵
suó$	s w ɔ ³⁵
suǒ$	s w ɔ ²¹⁴
suò$	s w ɔ ⁵¹
sū$	s u ⁵⁵
sú$	s u ³⁵
sǔ$	s u ²¹⁴
sù$	s u ⁵¹
sūn$	s ʊ n ⁵⁵
sún$	s ʊ n ³⁵
sǔn$	s ʊ n ²¹⁴
sùn$	s ʊ n ⁵¹
tao$	tʰ au ⁰
tā$	tʰ a ⁵⁵
tá$	tʰ a ³⁵
tǎ$	tʰ a ²¹⁴
tà$	tʰ a ⁵¹
tāi$	tʰ ai ⁵⁵
tái$	tʰ ai ³⁵
tǎi$	tʰ ai ²¹⁴
tài$	tʰ ai ⁵¹
tān$	tʰ a n ⁵⁵
tán$	tʰ a n ³⁵
tǎn$	tʰ a n ²¹⁴
tàn$	tʰ a n ⁵¹
tāng$	tʰ a ŋ ⁵⁵
táng$	tʰ a ŋ ³⁵
tǎng$	tʰ a ŋ ²¹⁴
tàng$	tʰ a ŋ ⁵¹
tāo$	tʰ au ⁵⁵
táo$	tʰ au ³⁵
tǎo$	tʰ au ²¹⁴
tào$	tʰ au ⁵¹
tēng$	tʰ ə ŋ ⁵⁵
téng$	tʰ ə ŋ ³⁵
těng$	tʰ ə ŋ ²¹⁴
tèng$	tʰ ə ŋ ⁵¹
tiān$	tʰ j ɛ n ⁵⁵
tián$	tʰ j ɛ n ³⁵
tiǎn$	tʰ j ɛ n ²¹⁴
tiàn$	tʰ j ɛ n ⁵¹
tiāo$	tʰ j au ⁵⁵
tiáo$	tʰ j au ³⁵
tiǎo$	tʰ j au ²¹⁴
tiào$	tʰ j au ⁵¹
tiē$	tʰ j ə ⁵⁵
tié$	tʰ j ə ³⁵
tiě$	tʰ j ə ²¹⁴
tiè$	tʰ j ə ⁵¹
tī$	tʰ i ⁵⁵
tí$	tʰ i ³⁵
tǐ$	tʰ i ²¹⁴
tì$	tʰ i ⁵¹
tīng$	tʰ i ŋ ⁵⁵
tíng$	tʰ i ŋ ³⁵
tǐng$	tʰ i ŋ ²¹⁴
tìng$	tʰ i ŋ ⁵¹
tou$	tʰ ɔu ⁰
tōng$	tʰ ʊ ŋ ⁵⁵
tóng$	tʰ ʊ ŋ ³⁵
tǒng$	tʰ ʊ ŋ ²¹⁴
tòng$	tʰ ʊ ŋ ⁵¹
tōu$	tʰ ɔu ⁵⁵
tóu$	tʰ ɔu ³⁵
tǒu$	tʰ ɔu ²¹⁴
tòu$	tʰ ɔu ⁵¹
tuān$	tʰ w a n ⁵⁵
tuán$	tʰ w a n ³⁵
tuǎn$	tʰ w a n ²¹⁴
tuàn$	tʰ w a n ⁵¹
tuī$	tʰ w əi ⁵⁵
tuí$	tʰ w əi ³⁵
tuǐ$	tʰ w əi ²¹⁴
tuì$	tʰ w əi ⁵¹
tuo$	tʰ w ɔ ⁰
tuō$	tʰ w ɔ ⁵⁵
tuó$	tʰ w ɔ ³⁵
tuǒ$	tʰ w ɔ ²¹⁴
tuò$	tʰ w ɔ ⁵¹
tū$	tʰ u ⁵⁵
tú$	tʰ u ³⁵
tǔ$	tʰ u ²¹⁴
tù$	tʰ u ⁵¹
tūn$	tʰ ʊ n ⁵⁵
tún$	tʰ ʊ n ³⁵
tǔn$	tʰ ʊ n ²¹⁴
tùn$	tʰ ʊ n ⁵¹
wā$	w a ⁵⁵
wá$	w a ³⁵
wǎ$	w a ²¹⁴
wà$	w a ⁵¹
wāi$	w ai ⁵⁵
wái$	w ai ³⁵
wǎi$	w ai ²¹⁴
wài$	w ai ⁵¹
wān$	w a n ⁵⁵
wán$	w a n ³⁵
wǎn$	w a n ²¹⁴
wàn$	w a n ⁵¹
wāng$	w a ŋ ⁵⁵
wáng$	w a ŋ ³⁵
wǎng$	w a ŋ ²¹⁴
wàng$	w a ŋ ⁵¹
wēi$	w əi ⁵⁵
wéi$	w əi ³⁵
wěi$	w əi ²¹⁴
wèi$	w əi ⁵¹
wēn$	w ə n ⁵⁵
wén$	w ə n ³⁵
wěn$	w ə n ²¹⁴
wèn$	w ə n ⁵¹
wō$	w ɔ ⁵⁵
wó$	w ɔ ³⁵
wǒ$	w ɔ ²¹⁴
wò$	w ɔ ⁵¹
wū$	w u ⁵⁵
wú$	w u ³⁵
wǔ$	w u ²¹⁴
wù$	w u ⁵¹
xi$	ɕ i ⁰
xiā$	ɕ j a ⁵⁵
xiá$	ɕ j a ³⁵
xiǎ$	ɕ j a ²¹⁴
xià$	ɕ j a ⁵¹
xiān$	ɕ j ɛ n ⁵⁵
xián$	ɕ j ɛ n ³⁵
xiǎn$	ɕ j ɛ n ²¹⁴
xiàn$	ɕ j ɛ n ⁵¹
xiāng$	ɕ j a ŋ ⁵⁵
xiáng$	ɕ j a ŋ ³⁵
xiǎng$	ɕ j a ŋ ²¹⁴
xiàng$	ɕ j a ŋ ⁵¹
xiāo$	ɕ j au ⁵⁵
xiáo$	ɕ j au ³⁵
xiǎo$	ɕ j au ²¹⁴
xiào$	ɕ j au ⁵¹
xiē$	ɕ j ə ⁵⁵
xié$	ɕ j ə ³⁵
xiě$	ɕ j ə ²¹⁴
xiè$	ɕ j ə ⁵¹
xiōng$	ɕ j ʊ ŋ ⁵⁵
xióng$	ɕ j ʊ ŋ ³⁵
xiǒng$	ɕ j ʊ ŋ ²¹⁴
xiòng$	ɕ j ʊ ŋ ⁵¹
xiū$	ɕ j ɔu ⁵⁵
xiú$	ɕ j ɔu ³⁵
xiǔ$	ɕ j ɔu ²¹⁴
xiù$	ɕ j ɔu ⁵¹
xī$	ɕ i ⁵⁵
xí$	ɕ i ³⁵
xǐ$	ɕ i ²¹⁴
xì$	ɕ i ⁵¹
xīn$	ɕ i n ⁵⁵
xín$	ɕ i n ³⁵
xǐn$	ɕ i n ²¹⁴
xìn$	ɕ i n ⁵¹
xīng$	ɕ i ŋ ⁵⁵
xíng$	ɕ i ŋ ³⁵
xǐng$	ɕ i ŋ ²¹⁴
xìng$	ɕ i ŋ ⁵¹
xu$	ɕ y ⁰
xuān$	ɕ ɥ ɛ n ⁵⁵
xuán$	ɕ ɥ ɛ n ³⁵
xuǎn$	ɕ ɥ ɛ n ²¹⁴
xuàn$	ɕ ɥ ɛ n ⁵¹
xuē$	ɕ ɥ ə ⁵⁵
xué$	ɕ ɥ ə ³⁵
xuě$	ɕ ɥ ə ²¹⁴
xuè$	ɕ ɥ ə ⁵¹
xū$	ɕ y ⁵⁵
xú$	ɕ y ³⁵
xǔ$	ɕ y ²¹⁴
xù$	ɕ y ⁵¹
xūn$	ɕ y n ⁵⁵
xún$	ɕ y n ³⁵
xǔn$	ɕ y n ²¹⁴
xùn$	ɕ y n ⁵¹
yā$	j a ⁵⁵
yá$	j a ³⁵
yǎ$	j a ²¹⁴
yà$	j a ⁵¹
yān$	j a n ⁵⁵
yán$	j a n ³⁵
yǎn$	j a n ²¹⁴
yàn$	j a n ⁵¹
yāng$	j a ŋ ⁵⁵
yáng$	j a ŋ ³⁵
yǎng$	j a ŋ ²¹⁴
yàng$	j a ŋ ⁵¹
yāo$	j au ⁵⁵
yáo$	j au ³⁵
yǎo$	j au ²¹⁴
yào$	j au ⁵¹
yē$	j ə ⁵⁵
yé$	j ə ³⁵
yě$	j ə ²¹⁴
yè$	j ə ⁵¹
yi$	j i ⁰
ying$	j i ŋ ⁰
yī$	j i ⁵⁵
yí$	j i ³⁵
yǐ$	j i ²¹⁴
yì$	j i ⁵¹
yīn$	j i n ⁵⁵
yín$	j i n ³⁵
yǐn$	j i n ²¹⁴
yìn$	j i n ⁵¹
yīng$	j i ŋ ⁵⁵
yíng$	j i ŋ ³⁵
yǐng$	j i ŋ ²¹⁴
yìng$	j i ŋ ⁵¹
you$	j ɔu ⁰
yōng$	j ʊ ŋ ⁵⁵
yóng$	j ʊ ŋ ³⁵
yǒng$	j ʊ ŋ ²¹⁴
yòng$	j ʊ ŋ ⁵¹
yōu$	j ɔu ⁵⁵
yóu$	j ɔu ³⁵
yǒu$	j ɔu ²¹⁴
yòu$	j ɔu ⁵¹
yuān$	ɥ ɛ n ⁵⁵
yuán$	ɥ ɛ n ³⁵
yuǎn$	ɥ ɛ n ²¹⁴
yuàn$	ɥ ɛ n ⁵¹
yuē$	ɥ ə ⁵⁵
yué$	ɥ ə ³⁵
yuě$	ɥ ə ²¹⁴
yuè$	ɥ ə ⁵¹
yū$	ɥ y ⁵⁵
yú$	ɥ y ³⁵
yǔ$	ɥ y ²¹⁴
yù$	ɥ y ⁵¹
yūn$	ɥ y n ⁵⁵
yún$	ɥ y n ³⁵
yǔn$	ɥ y n ²¹⁴
yùn$	ɥ y n ⁵¹
zao$	ts au ⁰
zāi$	ts ai ⁵⁵
zái$	ts ai ³⁵
zǎi$	ts ai ²¹⁴
zài$	ts ai ⁵¹
zān$	ts a n ⁵⁵
zán$	ts a n ³⁵
zǎn$	ts a n ²¹⁴
zàn$	ts a n ⁵¹
zāng$	ts a ŋ ⁵⁵
záng$	ts a ŋ ³⁵
zǎng$	ts a ŋ ²¹⁴
zàng$	ts a ŋ ⁵¹
zāo$	ts au ⁵⁵
záo$	ts au ³⁵
zǎo$	ts au ²¹⁴
zào$	ts au ⁵¹
zē$	ts ə ⁵⁵
zé$	ts ə ³⁵
zě$	ts ə ²¹⁴
zè$	ts ə ⁵¹
zhā$	ʈʂ a ⁵⁵
zhá$	ʈʂ a ³⁵
zhǎ$	ʈʂ a ²¹⁴
zhà$	ʈʂ a ⁵¹
zhāi$	ʈʂ ai ⁵⁵
zhái$	ʈʂ ai ³⁵
zhǎi$	ʈʂ ai ²¹⁴
zhài$	ʈʂ ai ⁵¹
zhān$	ʈʂ a n ⁵⁵
zhán$	ʈʂ a n ³⁵
zhǎn$	ʈʂ a n ²¹⁴
zhàn$	ʈʂ a n ⁵¹
zhāng$	ʈʂ a ŋ ⁵⁵
zháng$	ʈʂ a ŋ ³⁵
zhǎng$	ʈʂ a ŋ ²¹⁴
zhàng$	ʈʂ a ŋ ⁵¹
zhāo$	ʈʂ au ⁵⁵
zháo$	ʈʂ au ³⁵
zhǎo$	ʈʂ au ²¹⁴
zhào$	ʈʂ au ⁵¹
zhe$	ʈʂ ə ⁰
zhē$	ʈʂ ə ⁵⁵
zhé$	ʈʂ ə ³⁵
zhě$	ʈʂ ə ²¹⁴
zhè$	ʈʂ ə ⁵¹
zhēn$	ʈʂ ə n ⁵⁵
zhén$	ʈʂ ə n ³⁵
zhěn$	ʈʂ ə n ²¹⁴
zhèn$	ʈʂ ə n ⁵¹
zhēng$	ʈʂ ə ŋ ⁵⁵
zhéng$	ʈʂ ə ŋ ³⁵
zhěng$	ʈʂ ə ŋ ²¹⁴
zhèng$	ʈʂ ə ŋ ⁵¹
zhi$	ʈʂ ʅ ⁰
zhī$	ʈʂ ʅ ⁵⁵
zhí$	ʈʂ ʅ ³⁵
zhǐ$	ʈʂ ʅ ²¹⁴
zhì$	ʈʂ ʅ ⁵¹
zhou$	ʈʂ ɔu ⁰
zhōng$	ʈʂ ʊ ŋ ⁵⁵
zhóng$	ʈʂ ʊ ŋ ³⁵
zhǒng$	ʈʂ ʊ ŋ ²¹⁴
zhòng$	ʈʂ ʊ ŋ ⁵¹
zhōu$	ʈʂ ɔu ⁵⁵
zhóu$	ʈʂ ɔu ³⁵
zhǒu$	ʈʂ ɔu ²¹⁴
zhòu$	ʈʂ ɔu ⁵¹
zhuā$	ʈʂ w a ⁵⁵
zhuá$	ʈʂ w a ³⁵
zhuǎ$	ʈʂ w a ²¹⁴
zhuà$	ʈʂ w a ⁵¹
zhuān$	ʈʂ w a n ⁵⁵
zhuán$	ʈʂ w a n ³⁵
zhuǎn$	ʈʂ w a n ²¹⁴
zhuàn$	ʈʂ w a n ⁵¹
zhuāng$	ʈʂ w a ŋ ⁵⁵
zhuáng$	ʈʂ w a ŋ ³⁵
zhuǎng$	ʈʂ w a ŋ ²¹⁴
zhuàng$	ʈʂ w a ŋ ⁵¹
zhuī$	ʈʂ w əi ⁵⁵
zhuí$	ʈʂ w əi ³⁵
zhuǐ$	ʈʂ w əi ²¹⁴
zhuì$	ʈʂ w əi ⁵¹
zhuō$	ʈʂ w ɔ ⁵⁵
zhuó$	ʈʂ w ɔ ³⁵
zhuǒ$	ʈʂ w ɔ ²¹⁴
zhuò$	ʈʂ w ɔ ⁵¹
zhū$	ʈʂ u ⁵⁵
zhú$	ʈʂ u ³⁵
zhǔ$	ʈʂ u ²¹⁴
zhù$	ʈʂ u ⁵¹
zhūn$	ʈʂ ʊ n ⁵⁵
zhún$	ʈʂ ʊ n ³⁵
zhǔn$	ʈʂ ʊ n ²¹⁴
zhùn$	ʈʂ ʊ n ⁵¹
zi$	ts ɿ ⁰
zī$	ts ɿ ⁵⁵
zí$	ts ɿ ³⁵
zǐ$	ts ɿ ²¹⁴
zì$	ts ɿ ⁵¹
zōng$	ts ʊ ŋ ⁵⁵
zóng$	ts ʊ ŋ ³⁵
zǒng$	ts ʊ ŋ ²¹⁴
zòng$	ts ʊ ŋ ⁵¹
zōu$	ts ɔu ⁵⁵
zóu$	ts ɔu ³⁵
zǒu$	ts ɔu ²¹⁴
zòu$	ts ɔu ⁵¹
zuān$	ts w a n ⁵⁵
zuán$	ts w a n ³⁵
zuǎn$	ts w a n ²¹⁴
zuàn$	ts w a n ⁵¹
zuī$	ts w əi ⁵⁵
zuí$	ts w əi ³⁵
zuǐ$	ts w əi ²¹⁴
zuì$	ts w əi ⁵¹
zuō$	ts w ɔ ⁵⁵
zuó$	ts w ɔ ³⁵
zuǒ$	ts w ɔ ²¹⁴
zuò$	ts w ɔ ⁵¹
zū$	ts u ⁵⁵
zú$	ts u ³⁵
zǔ$	ts u ²¹⁴
zù$	ts u ⁵¹
